AAAAATAAGCG -> AAAATAAGCGG
AAAAGACGGAC -> AAAGACGGACT
AAAAGCGGTGC -> AAAGCGGTGCC
AAAAGGTCAAC -> AAAGGTCAACT
AAAAGTCGGCG -> AAAGTCGGCGA
AAAATAAGCGG -> AAATAAGCGGT
AAAATGCGCTA -> AAATGCGCTAA
AAAATGTCCTC -> AAATGTCCTCC
AAACATCATGT -> AACATCATGTA
AAACCGCAAGT -> AACCGCAAGTT
AAACCTTCATT -> AACCTTCATTT
AAACGGTTCGC -> AACGGTTCGCA
AAACTCCAAAA -> AACTCCAAAAT
AAACTGAGCAA -> AACTGAGCAAC
AAAGAAGCAGC -> AAGAAGCAGCC
AAAGACGGACT -> AAGACGGACTT
AAAGCATTCTT -> AAGCATTCTTG
AAAGCCTACCC -> AAGCCTACCCA
AAAGCGGTGCC -> AAGCGGTGCCC
AAAGCTCGGGT -> AAGCTCGGGTG
AAAGGTCAACT -> AAGGTCAACTG
AAAGTATATCC -> AAGTATATCCG
AAAGTCATATC -> AAGTCATATCC
AAAGTCGGCGA -> AAGTCGGCGAC
AAAGTGCCTTG -> AAGTGCCTTGT
AAATAAACGGT -> AATAAACGGTT
AAATAAGCGGT -> AATAAGCGGTC
AAATATACCCT -> AATATACCCTG
AAATGCCCCCC -> AATGCCCCCCT
AAATGCGCTAA -> AATGCGCTAAT
AAATGTCCTCC -> AATGTCCTCCA
AAATTTGCCAA -> AATTTGCCAAT
AACACATCATT -> ACACATCATTT
AACATCATGTA -> ACATCATGTAT
AACATCTTGCC -> ACATCTTGCCG
AACCAAGTCAG -> ACCAAGTCAGT
AACCACTCGGA -> ACCACTCGGAC
AACCATAAGAT -> ACCATAAGATT
AACCCCCTAGG -> ACCCCCTAGGC
AACCGCAAGTT -> ACCGCAAGTTT
AACCTGGATAC -> ACCTGGATACT
AACCTGGCTTG -> ACCTGGCTTGT
AACCTTCATTT -> ACCTTCATTTG
AACCTTCTTAG -> ACCTTCTTAGG
AACGACTATTA -> ACGACTATTAG
AACGAGGAACG -> ACGAGGAACGG
AACGCAATTAT -> ACGCAATTATC
AACGCCAAAGC -> ACGCCAAAGCA
AACGGCAGTTT -> ACGGCAGTTTT
AACGGCTTACG -> ACGGCTTACGA
AACGGGTCTAG -> ACGGGTCTAGA
AACGGTTCGCA -> ACGGTTCGCAT
AACGTTCTTAA -> ACGTTCTTAAG
AACGTTTTTTC -> ACGTTTTTTCC
AACTCCAAAAT -> ACTCCAAAATG
AACTCCGACGC -> ACTCCGACGCC
AACTGAGCAAC -> ACTGAGCAACG
AACTGAGGTCC -> ACTGAGGTCCA
AACTGCAAGTG -> ACTGCAAGTGC
AACTGGTACCT -> ACTGGTACCTA
AACTGTTTACC -> ACTGTTTACCG
AAGAACGTTCT -> AGAACGTTCTT
AAGAAGCAGCC -> AGAAGCAGCCA
AAGACGGACTT -> AGACGGACTTA
AAGATACGATC -> AGATACGATCT
AAGATTTGATA -> AGATTTGATAA
AAGCAGCCAAT -> AGCAGCCAATC
AAGCATTCTTG -> AGCATTCTTGA
AAGCCGCAATC -> AGCCGCAATCT
AAGCCTACCCA -> AGCCTACCCAC
AAGCGCATGCG -> AGCGCATGCGC
AAGCGGTATAT -> AGCGGTATATG
AAGCGGTCAAA -> AGCGGTCAAAG
AAGCGGTGCCC -> AGCGGTGCCCC
AAGCTACACGG -> AGCTACACGGG
AAGCTCGGGTG -> AGCTCGGGTGA
AAGGAGCGATC -> AGGAGCGATCC
AAGGAGTCAAT -> AGGAGTCAATC
AAGGCACACAT -> AGGCACACATG
AAGGCCCGATC -> AGGCCCGATCC
AAGGCGATTCA -> AGGCGATTCAA
AAGGCGTTTTC -> AGGCGTTTTCG
AAGGTCAACTG -> AGGTCAACTGT
AAGTATATCCG -> AGTATATCCGG
AAGTCAGTAAT -> AGTCAGTAATG
AAGTCATATCC -> AGTCATATCCT
AAGTCCGTCGA -> AGTCCGTCGAA
AAGTCGGCGAC -> AGTCGGCGACA
AAGTGCCTTGT -> AGTGCCTTGTC
AAGTGCGCGCT -> AGTGCGCGCTA
AAGTGTTCCTG -> AGTGTTCCTGT
AAGTTCACAAA -> AGTTCACAAAA
AAGTTCACCAG -> AGTTCACCAGA
AAGTTGCGCGA -> AGTTGCGCGAG
AAGTTTTTGCC -> AGTTTTTGCCT
AATAAACGGTT -> ATAAACGGTTC
AATAAGCGGTC -> ATAAGCGGTCA
AATACTCCTTA -> ATACTCCTTAC
AATACTGCCGT -> ATACTGCCGTA
AATAGTGCTAG -> ATAGTGCTAGT
AATATACCCTG -> ATATACCCTGA
AATCAATACTC -> ATCAATACTCC
AATCCACTGTC -> ATCCACTGTCC
AATCCCTCGCC -> ATCCCTCGCCC
AATCGATCTAA -> ATCGATCTAAT
AATCGCCAGCC -> ATCGCCAGCCA
AATCGGGACGG -> ATCGGGACGGA
AATCTACAAGG -> ATCTACAAGGC
AATCTCCCATA -> ATCTCCCATAT
AATCTCGTATA -> ATCTCGTATAA
AATCTGCCCGG -> ATCTGCCCGGG
AATGAAAATGT -> ATGAAAATGTC
AATGAGTTTTA -> ATGAGTTTTAC
AATGCCCCCCT -> ATGCCCCCCTC
AATGCGAGTCG -> ATGCGAGTCGA
AATGCGCTAAT -> ATGCGCTAATC
AATGCGTTGTG -> ATGCGTTGTGT
AATGGCGTTTA -> ATGGCGTTTAC
AATGTCCTCCA -> ATGTCCTCCAA
AATTATCACGT -> ATTATCACGTT
AATTATCTCAG -> ATTATCTCAGT
AATTCACCACC -> ATTCACCACCC
AATTCCCCAAT -> ATTCCCCAATA
AATTGCTCCGT -> ATTGCTCCGTG
AATTTAACCTG -> ATTTAACCTGG
AATTTGCCAAT -> ATTTGCCAATT
ACAAAAGGTCA -> CAAAAGGTCAA
ACAAAGTGCCT -> CAAAGTGCCTT
ACAACGCAATT -> CAACGCAATTA
ACAAGGCCCGA -> CAAGGCCCGAT
ACAATACTGCC -> CAATACTGCCG
ACACAACGCAA -> CACAACGCAAT
ACACACAGGCC -> CACACAGGCCT
ACACAGGCCTC -> CACAGGCCTCG
ACACATCATTT -> CACATCATTTA
ACACATGCCGT -> CACATGCCGTG
ACACATTTTGT -> CACATTTTGTG
ACACCAAAAGT -> CACCAAAAGTC
ACACGCAACGG -> CACGCAACGGC
ACACGGGAGAC -> CACGGGAGACA
ACAGCGCTGGT -> CAGCGCTGGTT
ACAGGCCTCGG -> CAGGCCTCGGA
ACAGTACATAT -> CAGTACATATC
ACAGTCGTAAG -> CAGTCGTAAGT
ACATATCGCGA -> CATATCGCGAA
ACATCATGTAT -> CATCATGTATA
ACATCATTTAT -> CATCATTTATC
ACATCCCATAC -> CATCCCATACG
ACATCGCTGCC -> CATCGCTGCCC
ACATCTTGCCG -> CATCTTGCCGG
ACATGCCGTGC -> CATGCCGTGCA
ACATGCTCCCC -> CATGCTCCCCC
ACATGTTTTAC -> CATGTTTTACA
ACATTTTGTGT -> CATTTTGTGTG
ACCAAAAGTCG -> CCAAAAGTCGG
ACCAAGTCAGT -> CCAAGTCAGTA
ACCACCCTAGT -> CCACCCTAGTC
ACCACCGAGAA -> CCACCGAGAAT
ACCACTCGGAC -> CCACTCGGACA
ACCAGAATCGG -> CCAGAATCGGG
ACCAGCCATCG -> CCAGCCATCGG
ACCAGGTAGCC -> CCAGGTAGCCA
ACCATAAGATT -> CCATAAGATTT
ACCCACGGCTA -> CCCACGGCTAC
ACCCACTATTC -> CCCACTATTCA
ACCCAGGTGCG -> CCCAGGTGCGG
ACCCCCTAGGC -> CCCCCTAGGCA
ACCCGGTTAAT -> CCCGGTTAATT
ACCCGTGGTCA -> CCCGTGGTCAG
ACCCTAGTCAG -> CCCTAGTCAGC
ACCCTGACTGG -> CCCTGACTGGG
ACCGAGAATCT -> CCGAGAATCTC
ACCGCAAGTTT -> CCGCAAGTTTT
ACCGCAGGAGA -> CCGCAGGAGAC
ACCGCTCTTCG -> CCGCTCTTCGT
ACCGCTTAGCT -> CCGCTTAGCTT
ACCGGATTACT -> CCGGATTACTG
ACCGGGGAAGC -> CCGGGGAAGCG
ACCGGGGCGAG -> CCGGGGCGAGA
ACCTAAGCTAC -> CCTAAGCTACA
ACCTATAGGTA -> CCTATAGGTAT
ACCTCACACAC -> CCTCACACACA
ACCTGGATACT -> CCTGGATACTC
ACCTGGCTTGT -> CCTGGCTTGTC
ACCTTACATCC -> CCTTACATCCC
ACCTTCATTTG -> CCTTCATTTGA
ACCTTCTTAGG -> CCTTCTTAGGC
ACGAAAAATAA -> CGAAAAATAAG
ACGAAGGAGTC -> CGAAGGAGTCA
ACGACCGCAGG -> CGACCGCAGGA
ACGACTATTAG -> CGACTATTAGT
ACGAGGAACGG -> CGAGGAACGGC
ACGAGTCCCCA -> CGAGTCCCCAC
ACGATAACGCC -> CGATAACGCCA
ACGATCTGTGT -> CGATCTGTGTT
ACGCAACGGCT -> CGCAACGGCTT
ACGCAAGTTGC -> CGCAAGTTGCG
ACGCAATTATC -> CGCAATTATCT
ACGCATATGAC -> CGCATATGACC
ACGCCAAAGCA -> CGCCAAAGCAT
ACGCCACGTTG -> CGCCACGTTGA
ACGCCTTCTGC -> CGCCTTCTGCT
ACGGAAAGAAG -> CGGAAAGAAGC
ACGGACGTGCT -> CGGACGTGCTA
ACGGACTTACG -> CGGACTTACGG
ACGGCAGTTTT -> CGGCAGTTTTT
ACGGCTACTTA -> CGGCTACTTAC
ACGGCTTACGA -> CGGCTTACGAA
ACGGGAGACAG -> CGGGAGACAGT
ACGGGTCTAGA -> CGGGTCTAGAG
ACGGTAACTGC -> CGGTAACTGCA
ACGGTGTCTCG -> CGGTGTCTCGG
ACGGTTATTGC -> CGGTTATTGCC
ACGGTTCGCAT -> CGGTTCGCATG
ACGTCGCCGAC -> CGTCGCCGACG
ACGTCGCTTTG -> CGTCGCTTTGG
ACGTGCTAGCA -> CGTGCTAGCAA
ACGTTCACATG -> CGTTCACATGC
ACGTTCTTAAG -> CGTTCTTAAGT
ACGTTCTTCAT -> CGTTCTTCATT
ACGTTGACAGT -> CGTTGACAGTC
ACGTTTACTCC -> CGTTTACTCCA
ACGTTTTCTAT -> CGTTTTCTATT
ACGTTTTTTCC -> CGTTTTTTCCC
ACTAAAGCCTA -> CTAAAGCCTAC
ACTATATGCGC -> CTATATGCGCT
ACTATCAATCC -> CTATCAATCCA
ACTATTAGTGA -> CTATTAGTGAT
ACTATTCAGCG -> CTATTCAGCGG
ACTCATCGATT -> CTCATCGATTG
ACTCCAAAATG -> CTCCAAAATGC
ACTCCAGAGAG -> CTCCAGAGAGG
ACTCCATGACA -> CTCCATGACAG
ACTCCGACGCC -> CTCCGACGCCA
ACTCCTTACGG -> CTCCTTACGGA
ACTCGGACACC -> CTCGGACACCA
ACTGAGCAACG -> CTGAGCAACGG
ACTGAGGTCCA -> CTGAGGTCCAC
ACTGATATTTT -> CTGATATTTTC
ACTGCAAGTGC -> CTGCAAGTGCG
ACTGCCGTAGG -> CTGCCGTAGGC
ACTGGGTCTTC -> CTGGGTCTTCC
ACTGGGTGGAC -> CTGGGTGGACG
ACTGGTACCTA -> CTGGTACCTAA
ACTGTCCGCTC -> CTGTCCGCTCC
ACTGTGGGATG -> CTGTGGGATGA
ACTGTTTACCG -> CTGTTTACCGC
ACTGTTTGGTT -> CTGTTTGGTTG
ACTTACATCGC -> CTTACATCGCT
ACTTACGGTTA -> CTTACGGTTAT
ACTTCTTTTCC -> CTTCTTTTCCC
AGAACGTTCTT -> GAACGTTCTTA
AGAAGCAGCCA -> GAAGCAGCCAA
AGAATCGGGAC -> GAATCGGGACG
AGAATCTCGTA -> GAATCTCGTAT
AGAATGAGTTT -> GAATGAGTTTT
AGACACATTTT -> GACACATTTTG
AGACAGTACAT -> GACAGTACATA
AGACCTCACAC -> GACCTCACACA
AGACGGACTTA -> GACGGACTTAC
AGAGAGGGAAG -> GAGAGGGAAGG
AGAGGAACCTT -> GAGGAACCTTC
AGAGGGAAGGA -> GAGGGAAGGAG
AGAGGTTGGGA -> GAGGTTGGGAA
AGAGTTTTGCA -> GAGTTTTGCAG
AGATAATTATC -> GATAATTATCA
AGATACGATCT -> GATACGATCTG
AGATTTAAGAA -> GATTTAAGAAC
AGATTTGATAA -> GATTTGATAAA
AGCAAACTCCA -> GCAAACTCCAA
AGCAACGGGTC -> GCAACGGGTCT
AGCACGCATAT -> GCACGCATATG
AGCACGTTTAC -> GCACGTTTACT
AGCAGCCAATC -> GCAGCCAATCC
AGCAGCGGAGG -> GCAGCGGAGGG
AGCATTCTTGA -> GCATTCTTGAG
AGCCAATCCCT -> GCCAATCCCTC
AGCCAATTGCT -> GCCAATTGCTC
AGCCATCGGCG -> GCCATCGGCGT
AGCCATTGTAG -> GCCATTGTAGC
AGCCGCAATCT -> GCCGCAATCTG
AGCCTACCCAC -> GCCTACCCACG
AGCCTCTCCTG -> GCCTCTCCTGT
AGCGATCCTGG -> GCGATCCTGGC
AGCGCATGCGC -> GCGCATGCGCG
AGCGCCACCTT -> GCGCCACCTTA
AGCGCTGGTTG -> GCGCTGGTTGA
AGCGGAGGGTG -> GCGGAGGGTGA
AGCGGCCCCAA -> GCGGCCCCAAA
AGCGGTATATG -> GCGGTATATGG
AGCGGTCAAAG -> GCGGTCAAAGC
AGCGGTGCCCC -> GCGGTGCCCCG
AGCTACACGGG -> GCTACACGGGA
AGCTCGGGTGA -> GCTCGGGTGAA
AGCTCTCTAGA -> GCTCTCTAGAT
AGCTTCTTGGT -> GCTTCTTGGTA
AGGAACCATAA -> GGAACCATAAG
AGGAACCTTCT -> GGAACCTTCTT
AGGAACGGCAG -> GGAACGGCAGT
AGGAACTGGTA -> GGAACTGGTAC
AGGAATTTAAC -> GGAATTTAACC
AGGACGTCGCT -> GGACGTCGCTT
AGGACTGTTTG -> GGACTGTTTGG
AGGAGACACAT -> GGAGACACATT
AGGAGCGATCC -> GGAGCGATCCT
AGGAGTCAATC -> GGAGTCAATCT
AGGATGCCGCG -> GGATGCCGCGC
AGGCACAATAC -> GGCACAATACT
AGGCACACATG -> GGCACACATGC
AGGCAGATTTA -> GGCAGATTTAA
AGGCCAATCGC -> GGCCAATCGCC
AGGCCCGATCC -> GGCCCGATCCC
AGGCCTCGGAA -> GGCCTCGGAAC
AGGCGATTCAA -> GGCGATTCAAA
AGGCGTTTTCG -> GGCGTTTTCGT
AGGCTAGTTGA -> GGCTAGTTGAG
AGGCTCTAACA -> GGCTCTAACAT
AGGGAAACCGC -> GGGAAACCGCA
AGGGAAGGAGC -> GGGAAGGAGCG
AGGGAGGAATT -> GGGAGGAATTT
AGGGTGAGGCC -> GGGTGAGGCCA
AGGGTGCGCAT -> GGGTGCGCATA
AGGTAACACAT -> GGTAACACATC
AGGTAGCCAAT -> GGTAGCCAATT
AGGTATTGAGT -> GGTATTGAGTC
AGGTCAACTGT -> GGTCAACTGTT
AGGTCCACGGT -> GGTCCACGGTA
AGGTGCGGTCG -> GGTGCGGTCGC
AGGTGTCAGTA -> GGTGTCAGTAT
AGGTTATCAGA -> GGTTATCAGAG
AGGTTGGGAAC -> GGTTGGGAACT
AGTAATGAAAA -> GTAATGAAAAT
AGTACATATCG -> GTACATATCGC
AGTAGGAACTG -> GTAGGAACTGG
AGTATATCCGG -> GTATATCCGGC
AGTATCCTTTG -> GTATCCTTTGT
AGTCAATCAAT -> GTCAATCAATA
AGTCAATCTAC -> GTCAATCTACA
AGTCAGCTCTC -> GTCAGCTCTCT
AGTCAGGACGT -> GTCAGGACGTC
AGTCAGTAATG -> GTCAGTAATGA
AGTCATATCCT -> GTCATATCCTA
AGTCCCCACGA -> GTCCCCACGAC
AGTCCGTCGAA -> GTCCGTCGAAA
AGTCGACTGAT -> GTCGACTGATA
AGTCGGCGACA -> GTCGGCGACAT
AGTCGTAAGTT -> GTCGTAAGTTC
AGTCTGCGGAA -> GTCTGCGGAAC
AGTGATTAAGG -> GTGATTAAGGC
AGTGCCTTGTC -> GTGCCTTGTCG
AGTGCGCGCTA -> GTGCGCGCTAA
AGTGCTAGTCA -> GTGCTAGTCAA
AGTGTTCCTGT -> GTGTTCCTGTA
AGTTCAAACTG -> GTTCAAACTGA
AGTTCACAAAA -> GTTCACAAAAG
AGTTCACCAGA -> GTTCACCAGAA
AGTTCTCTTAT -> GTTCTCTTATC
AGTTGAGGTAA -> GTTGAGGTAAC
AGTTGCGCGAG -> GTTGCGCGAGG
AGTTGGTGCTG -> GTTGGTGCTGG
AGTTTTACCCA -> GTTTTACCCAC
AGTTTTGCAGC -> GTTTTGCAGCA
AGTTTTTCGTC -> GTTTTTCGTCG
AGTTTTTGCCT -> GTTTTTGCCTC
ATAAACGGTTC -> TAAACGGTTCG
ATAAATATACC -> TAAATATACCC
ATAACGCCAAA -> TAACGCCAAAG
ATAAGATTTGA -> TAAGATTTGAT
ATAAGCGGTCA -> TAAGCGGTCAA
ATAAGGCGTTT -> TAAGGCGTTTT
ATAATGCGTTG -> TAATGCGTTGT
ATAATTATCAC -> TAATTATCACG
ATACCCTGACT -> TACCCTGACTG
ATACGAGTCCC -> TACGAGTCCCC
ATACGATCTGT -> TACGATCTGTG
ATACGGTGTCT -> TACGGTGTCTC
ATACTCCATGA -> TACTCCATGAC
ATACTCCTTAC -> TACTCCTTACG
ATACTGCCGTA -> TACTGCCGTAG
ATAGAATGAGT -> TAGAATGAGTT
ATAGGACTGTT -> TAGGACTGTTT
ATAGGCCAATC -> TAGGCCAATCG
ATAGGTATTGA -> TAGGTATTGAG
ATAGTGCTAGT -> TAGTGCTAGTC
ATAGTTCAAAC -> TAGTTCAAACT
ATATACCCTGA -> TATACCCTGAC
ATATAGTTCAA -> TATAGTTCAAA
ATATCCGGCCG -> TATCCGGCCGC
ATATCCTAGCA -> TATCCTAGCAC
ATATCGCGAAG -> TATCGCGAAGG
ATATGACCGGG -> TATGACCGGGG
ATATGCGCTCC -> TATGCGCTCCC
ATATGGAGGGT -> TATGGAGGGTG
ATATGGTACGA -> TATGGTACGAA
ATATTTTCTCA -> TATTTTCTCAC
ATCAATACTCC -> TCAATACTCCT
ATCAATCCACT -> TCAATCCACTG
ATCACGTTCAC -> TCACGTTCACA
ATCAGAGGTTG -> TCAGAGGTTGG
ATCAGGGAGGA -> TCAGGGAGGAA
ATCATGTATAA -> TCATGTATAAG
ATCATTTATCA -> TCATTTATCAG
ATCCACTGTCC -> TCCACTGTCCG
ATCCCATACGA -> TCCCATACGAG
ATCCCGAGGCA -> TCCCGAGGCAC
ATCCCTCGCCC -> TCCCTCGCCCG
ATCCGGCCGCA -> TCCGGCCGCAG
ATCCTAGCACG -> TCCTAGCACGT
ATCCTGGCTGA -> TCCTGGCTGAT
ATCCTGTATAG -> TCCTGTATAGA
ATCCTTTGTCT -> TCCTTTGTCTA
ATCGATCTAAT -> TCGATCTAATG
ATCGATTGCCG -> TCGATTGCCGT
ATCGCCAGCCA -> TCGCCAGCCAT
ATCGCGAAGGC -> TCGCGAAGGCA
ATCGCTGCCCA -> TCGCTGCCCAC
ATCGGCGTCAC -> TCGGCGTCACG
ATCGGGACGGA -> TCGGGACGGAA
ATCTAATGGCG -> TCTAATGGCGT
ATCTACAAGGC -> TCTACAAGGCC
ATCTACTCATC -> TCTACTCATCG
ATCTCAGTTCT -> TCTCAGTTCTC
ATCTCCCATAT -> TCTCCCATATA
ATCTCCTCCTC -> TCTCCTCCTCC
ATCTCGTATAA -> TCTCGTATAAT
ATCTGCCCGGG -> TCTGCCCGGGG
ATCTGTGTTGA -> TCTGTGTTGAC
ATCTTGCCGGT -> TCTTGCCGGTG
ATGAAAATGTC -> TGAAAATGTCC
ATGACAGCGCT -> TGACAGCGCTG
ATGACCGGGGA -> TGACCGGGGAA
ATGACGTCGCC -> TGACGTCGCCG
ATGAGTTTTAC -> TGAGTTTTACC
ATGATTAACCA -> TGATTAACCAA
ATGCCCCCCTC -> TGCCCCCCTCG
ATGCCGCGCTC -> TGCCGCGCTCG
ATGCCGTGCAC -> TGCCGTGCACA
ATGCGAGTCGA -> TGCGAGTCGAC
ATGCGCGTGAT -> TGCGCGTGATA
ATGCGCTAATC -> TGCGCTAATCT
ATGCGCTCCCA -> TGCGCTCCCAG
ATGCGTTGTGT -> TGCGTTGTGTT
ATGCTCCCCCT -> TGCTCCCCCTA
ATGGAGGGTGC -> TGGAGGGTGCG
ATGGCGACTAA -> TGGCGACTAAA
ATGGCGTTTAC -> TGGCGTTTACC
ATGGTACGAAG -> TGGTACGAAGG
ATGTACCGGAT -> TGTACCGGATT
ATGTATAAGGC -> TGTATAAGGCG
ATGTCCTCCAA -> TGTCCTCCAAA
ATGTGATCTCC -> TGTGATCTCCT
ATGTTTTACAA -> TGTTTTACAAA
ATGTTTTGGAA -> TGTTTTGGAAC
ATTAACCAAGT -> TTAACCAAGTC
ATTAACGTTTT -> TTAACGTTTTT
ATTAAGGCGAT -> TTAAGGCGATT
ATTACTGTGGG -> TTACTGTGGGA
ATTAGGTGTCA -> TTAGGTGTCAG
ATTAGTGATTA -> TTAGTGATTAA
ATTATCACGTT -> TTATCACGTTC
ATTATCTCAGT -> TTATCTCAGTT
ATTCAAATTTG -> TTCAAATTTGC
ATTCAATGCGA -> TTCAATGCGAG
ATTCACCACCC -> TTCACCACCCT
ATTCAGCGGCC -> TTCAGCGGCCC
ATTCCCCAATA -> TTCCCCAATAG
ATTCTTGAGGA -> TTCTTGAGGAA
ATTGAGTCTGC -> TTGAGTCTGCG
ATTGCCAATCG -> TTGCCAATCGA
ATTGCCGTGTA -> TTGCCGTGTAA
ATTGCTCCGTG -> TTGCTCCGTGT
ATTGTAGCCTC -> TTGTAGCCTCT
ATTTAACCTGG -> TTTAACCTGGC
ATTTAAGAACG -> TTTAAGAACGT
ATTTATCAGGG -> TTTATCAGGGA
ATTTCCTGAAA -> TTTCCTGAAAT
ATTTGACACGC -> TTTGACACGCA
ATTTGATAAAT -> TTTGATAAATA
ATTTGCCAATT -> TTTGCCAATTC
ATTTTCTCACG -> TTTTCTCACGT
ATTTTGTGTGC -> TTTTGTGTGCG
CAAAAGGTCAA -> AAAAGGTCAAC
CAAAAGTCGGC -> AAAAGTCGGCG
CAAAATGCGCT -> AAAATGCGCTA
CAAACCTTCAT -> AAACCTTCATT
CAAACTCCAAA -> AAACTCCAAAA
CAAACTGAGCA -> AAACTGAGCAA
CAAAGCATTCT -> AAAGCATTCTT
CAAAGCTCGGG -> AAAGCTCGGGT
CAAAGTATATC -> AAAGTATATCC
CAAAGTGCCTT -> AAAGTGCCTTG
CAAATAAACGG -> AAATAAACGGT
CAAATTTGCCA -> AAATTTGCCAA
CAACGCAATTA -> AACGCAATTAT
CAACGGCTTAC -> AACGGCTTACG
CAACGGGTCTA -> AACGGGTCTAG
CAACTGTTTAC -> AACTGTTTACC
CAAGGCCCGAT -> AAGGCCCGATC
CAAGTCAGTAA -> AAGTCAGTAAT
CAAGTGCGCGC -> AAGTGCGCGCT
CAAGTTGCGCG -> AAGTTGCGCGA
CAAGTTTTTGC -> AAGTTTTTGCC
CAATACTCCTT -> AATACTCCTTA
CAATACTGCCG -> AATACTGCCGT
CAATAGTGCTA -> AATAGTGCTAG
CAATCAATACT -> AATCAATACTC
CAATCCACTGT -> AATCCACTGTC
CAATCCCTCGC -> AATCCCTCGCC
CAATCGATCTA -> AATCGATCTAA
CAATCGCCAGC -> AATCGCCAGCC
CAATCTACAAG -> AATCTACAAGG
CAATCTGCCCG -> AATCTGCCCGG
CAATGCGAGTC -> AATGCGAGTCG
CAATTATCTCA -> AATTATCTCAG
CAATTCCCCAA -> AATTCCCCAAT
CAATTGCTCCG -> AATTGCTCCGT
CACAAAAGGTC -> ACAAAAGGTCA
CACAACGCAAT -> ACAACGCAATT
CACAATACTGC -> ACAATACTGCC
CACACAACGCA -> ACACAACGCAA
CACACACAGGC -> ACACACAGGCC
CACACAGGCCT -> ACACAGGCCTC
CACACATGCCG -> ACACATGCCGT
CACAGGCCTCG -> ACAGGCCTCGG
CACATCATTTA -> ACATCATTTAT
CACATGCCGTG -> ACATGCCGTGC
CACATGCTCCC -> ACATGCTCCCC
CACATTTTGTG -> ACATTTTGTGT
CACCAAAAGTC -> ACCAAAAGTCG
CACCACCCTAG -> ACCACCCTAGT
CACCAGAATCG -> ACCAGAATCGG
CACCAGCCATC -> ACCAGCCATCG
CACCCAGGTGC -> ACCCAGGTGCG
CACCCGGTTAA -> ACCCGGTTAAT
CACCCTAGTCA -> ACCCTAGTCAG
CACCGAGAATC -> ACCGAGAATCT
CACCTTACATC -> ACCTTACATCC
CACGACCGCAG -> ACGACCGCAGG
CACGATAACGC -> ACGATAACGCC
CACGCAACGGC -> ACGCAACGGCT
CACGCAAGTTG -> ACGCAAGTTGC
CACGCATATGA -> ACGCATATGAC
CACGGCTACTT -> ACGGCTACTTA
CACGGGAGACA -> ACGGGAGACAG
CACGGTAACTG -> ACGGTAACTGC
CACGTTCACAT -> ACGTTCACATG
CACGTTCTTCA -> ACGTTCTTCAT
CACGTTGACAG -> ACGTTGACAGT
CACGTTTACTC -> ACGTTTACTCC
CACTATTCAGC -> ACTATTCAGCG
CACTCGGACAC -> ACTCGGACACC
CACTGTCCGCT -> ACTGTCCGCTC
CACTTCTTTTC -> ACTTCTTTTCC
CAGAATCGGGA -> AGAATCGGGAC
CAGAGAGGGAA -> AGAGAGGGAAG
CAGAGGTTGGG -> AGAGGTTGGGA
CAGAGTTTTGC -> AGAGTTTTGCA
CAGATTTAAGA -> AGATTTAAGAA
CAGCACGCATA -> AGCACGCATAT
CAGCAGCGGAG -> AGCAGCGGAGG
CAGCCAATCCC -> AGCCAATCCCT
CAGCCATCGGC -> AGCCATCGGCG
CAGCCATTGTA -> AGCCATTGTAG
CAGCGCTGGTT -> AGCGCTGGTTG
CAGCGGAGGGT -> AGCGGAGGGTG
CAGCGGCCCCA -> AGCGGCCCCAA
CAGCTCTCTAG -> AGCTCTCTAGA
CAGGACGTCGC -> AGGACGTCGCT
CAGGAGACACA -> AGGAGACACAT
CAGGCCTCGGA -> AGGCCTCGGAA
CAGGGAAACCG -> AGGGAAACCGC
CAGGGAGGAAT -> AGGGAGGAATT
CAGGTAGCCAA -> AGGTAGCCAAT
CAGGTGCGGTC -> AGGTGCGGTCG
CAGGTTATCAG -> AGGTTATCAGA
CAGTAATGAAA -> AGTAATGAAAA
CAGTACATATC -> AGTACATATCG
CAGTATCCTTT -> AGTATCCTTTG
CAGTCAGGACG -> AGTCAGGACGT
CAGTCGTAAGT -> AGTCGTAAGTT
CAGTTCTCTTA -> AGTTCTCTTAT
CAGTTGGTGCT -> AGTTGGTGCTG
CAGTTTTTCGT -> AGTTTTTCGTC
CATAAGATTTG -> ATAAGATTTGA
CATACGAGTCC -> ATACGAGTCCC
CATACGGTGTC -> ATACGGTGTCT
CATAGGACTGT -> ATAGGACTGTT
CATATAGTTCA -> ATATAGTTCAA
CATATCCTAGC -> ATATCCTAGCA
CATATCGCGAA -> ATATCGCGAAG
CATATGACCGG -> ATATGACCGGG
CATCATGTATA -> ATCATGTATAA
CATCATTTATC -> ATCATTTATCA
CATCCCATACG -> ATCCCATACGA
CATCGATTGCC -> ATCGATTGCCG
CATCGCTGCCC -> ATCGCTGCCCA
CATCGGCGTCA -> ATCGGCGTCAC
CATCTTGCCGG -> ATCTTGCCGGT
CATGACAGCGC -> ATGACAGCGCT
CATGATTAACC -> ATGATTAACCA
CATGCCGTGCA -> ATGCCGTGCAC
CATGCGCGTGA -> ATGCGCGTGAT
CATGCTCCCCC -> ATGCTCCCCCT
CATGTACCGGA -> ATGTACCGGAT
CATGTATAAGG -> ATGTATAAGGC
CATGTTTTACA -> ATGTTTTACAA
CATTAACGTTT -> ATTAACGTTTT
CATTCTTGAGG -> ATTCTTGAGGA
CATTGTAGCCT -> ATTGTAGCCTC
CATTTATCAGG -> ATTTATCAGGG
CATTTCCTGAA -> ATTTCCTGAAA
CATTTGACACG -> ATTTGACACGC
CATTTTGTGTG -> ATTTTGTGTGC
CCAAAAGTCGG -> CAAAAGTCGGC
CCAAAATGCGC -> CAAAATGCGCT
CCAAACCTTCA -> CAAACCTTCAT
CCAAAGCATTC -> CAAAGCATTCT
CCAAAGTATAT -> CAAAGTATATC
CCAAATAAACG -> CAAATAAACGG
CCAAGTCAGTA -> CAAGTCAGTAA
CCAATAGTGCT -> CAATAGTGCTA
CCAATCCCTCG -> CAATCCCTCGC
CCAATCGATCT -> CAATCGATCTA
CCAATCGCCAG -> CAATCGCCAGC
CCAATTCCCCA -> CAATTCCCCAA
CCAATTGCTCC -> CAATTGCTCCG
CCACCAGCCAT -> CACCAGCCATC
CCACCCTAGTC -> CACCCTAGTCA
CCACCGAGAAT -> CACCGAGAATC
CCACCTTACAT -> CACCTTACATC
CCACGACCGCA -> CACGACCGCAG
CCACGCAAGTT -> CACGCAAGTTG
CCACGGCTACT -> CACGGCTACTT
CCACGGTAACT -> CACGGTAACTG
CCACGTTGACA -> CACGTTGACAG
CCACTATTCAG -> CACTATTCAGC
CCACTCGGACA -> CACTCGGACAC
CCACTGTCCGC -> CACTGTCCGCT
CCACTTCTTTT -> CACTTCTTTTC
CCAGAATCGGG -> CAGAATCGGGA
CCAGAGAGGGA -> CAGAGAGGGAA
CCAGCCATCGG -> CAGCCATCGGC
CCAGCCATTGT -> CAGCCATTGTA
CCAGGTAGCCA -> CAGGTAGCCAA
CCAGGTGCGGT -> CAGGTGCGGTC
CCAGGTTATCA -> CAGGTTATCAG
CCAGTCAGGAC -> CAGTCAGGACG
CCATAAGATTT -> CATAAGATTTG
CCATACGAGTC -> CATACGAGTCC
CCATATAGTTC -> CATATAGTTCA
CCATCGGCGTC -> CATCGGCGTCA
CCATGACAGCG -> CATGACAGCGC
CCATTGTAGCC -> CATTGTAGCCT
CCCAAATAAAC -> CCAAATAAACG
CCCAATAGTGC -> CCAATAGTGCT
CCCACCAGCCA -> CCACCAGCCAT
CCCACGACCGC -> CCACGACCGCA
CCCACGCAAGT -> CCACGCAAGTT
CCCACGGCTAC -> CCACGGCTACT
CCCACTATTCA -> CCACTATTCAG
CCCACTTCTTT -> CCACTTCTTTT
CCCAGGTGCGG -> CCAGGTGCGGT
CCCAGTCAGGA -> CCAGTCAGGAC
CCCATACGAGT -> CCATACGAGTC
CCCATATAGTT -> CCATATAGTTC
CCCCAAATAAA -> CCCAAATAAAC
CCCCAATAGTG -> CCCAATAGTGC
CCCCACGACCG -> CCCACGACCGC
CCCCCCTCGCC -> CCCCCTCGCCA
CCCCCTAAGTC -> CCCCTAAGTCC
CCCCCTAGGCA -> CCCCTAGGCAG
CCCCCTCGCCA -> CCCCTCGCCAG
CCCCGCATGTA -> CCCGCATGTAC
CCCCTAAGTCC -> CCCTAAGTCCG
CCCCTAGGCAG -> CCCTAGGCAGA
CCCCTCGCCAG -> CCCTCGCCAGG
CCCGAGGCACA -> CCGAGGCACAA
CCCGATCCCGA -> CCGATCCCGAG
CCCGCATGTAC -> CCGCATGTACC
CCCGGGGGCTC -> CCGGGGGCTCT
CCCGGTTAATT -> CCGGTTAATTC
CCCGTGGATGG -> CCGTGGATGGC
CCCGTGGTCAG -> CCGTGGTCAGT
CCCTAAGTCCG -> CCTAAGTCCGT
CCCTAGGCAGA -> CCTAGGCAGAT
CCCTAGTCAGC -> CCTAGTCAGCT
CCCTCGCCAGG -> CCTCGCCAGGT
CCCTCGCCCGT -> CCTCGCCCGTG
CCCTGACTGGG -> CCTGACTGGGT
CCGACGCCACG -> CGACGCCACGT
CCGACGTTTTC -> CGACGTTTTCT
CCGAGAATCTC -> CGAGAATCTCG
CCGAGGCACAA -> CGAGGCACAAT
CCGATCCCGAG -> CGATCCCGAGG
CCGCAAGTTTT -> CGCAAGTTTTT
CCGCAATCTGC -> CGCAATCTGCC
CCGCAGAGTTT -> CGCAGAGTTTT
CCGCAGGAGAC -> CGCAGGAGACA
CCGCATGTACC -> CGCATGTACCG
CCGCGCCTGTC -> CGCGCCTGTCA
CCGCGCTCGCG -> CGCGCTCGCGA
CCGCTCCTACC -> CGCTCCTACCG
CCGCTCTTCGT -> CGCTCTTCGTT
CCGCTTAGCTT -> CGCTTAGCTTC
CCGGATTACTG -> CGGATTACTGT
CCGGCCGCAGA -> CGGCCGCAGAG
CCGGGGAAGCG -> CGGGGAAGCGG
CCGGGGCGAGA -> CGGGGCGAGAC
CCGGGGGCTCT -> CGGGGGCTCTG
CCGGTGGCTAC -> CGGTGGCTACT
CCGGTTAATTC -> CGGTTAATTCA
CCGGTTACCAC -> CGGTTACCACC
CCGTAGGCTAG -> CGTAGGCTAGT
CCGTCGAAAAG -> CGTCGAAAAGA
CCGTGCACACA -> CGTGCACACAA
CCGTGGATGGC -> CGTGGATGGCG
CCGTGGTCAGT -> CGTGGTCAGTT
CCGTGTAAACA -> CGTGTAAACAT
CCGTGTGCAGG -> CGTGTGCAGGG
CCTAAGCTACA -> CTAAGCTACAC
CCTAAGTCCGT -> CTAAGTCCGTC
CCTACCCACGG -> CTACCCACGGC
CCTACCGCTCT -> CTACCGCTCTT
CCTAGCACGTT -> CTAGCACGTTT
CCTAGGCAGAT -> CTAGGCAGATT
CCTAGTCAGCT -> CTAGTCAGCTC
CCTATAGGTAT -> CTATAGGTATT
CCTATGTTTTG -> CTATGTTTTGG
CCTCACACACA -> CTCACACACAG
CCTCCAAACCT -> CTCCAAACCTT
CCTCCTATGTT -> CTCCTATGTTT
CCTCCTCCTAT -> CTCCTCCTATG
CCTCGCCAGGT -> CTCGCCAGGTT
CCTCGCCCGTG -> CTCGCCCGTGG
CCTCGGAACCC -> CTCGGAACCCC
CCTCTCCTGTT -> CTCTCCTGTTA
CCTCTTAACCA -> CTCTTAACCAC
CCTGAAATGCC -> CTGAAATGCCC
CCTGACTGGGT -> CTGACTGGGTG
CCTGGATACTC -> CTGGATACTCC
CCTGGCTGATG -> CTGGCTGATGT
CCTGGCTTGTC -> CTGGCTTGTCA
CCTGTACCAGG -> CTGTACCAGGT
CCTGTATAGAA -> CTGTATAGAAT
CCTGTCATAGG -> CTGTCATAGGA
CCTGTTACCTA -> CTGTTACCTAT
CCTTACATCCC -> CTTACATCCCA
CCTTACGGACG -> CTTACGGACGT
CCTTCATTTGA -> CTTCATTTGAC
CCTTCTGCTGG -> CTTCTGCTGGT
CCTTCTTAGGC -> CTTCTTAGGCT
CCTTGTCGTGG -> CTTGTCGTGGC
CCTTTGTCTAA -> CTTTGTCTAAG
CGAAAAATAAG -> GAAAAATAAGC
CGAAAAGACGG -> GAAAAGACGGA
CGAAAAGCGGT -> GAAAAGCGGTG
CGAAGGAGTCA -> GAAGGAGTCAA
CGAAGGCACAC -> GAAGGCACACA
CGACATGTTTT -> GACATGTTTTA
CGACCGCAGGA -> GACCGCAGGAG
CGACGCCACGT -> GACGCCACGTT
CGACGTTTTCT -> GACGTTTTCTA
CGACTAAAGCC -> GACTAAAGCCT
CGACTATCAAT -> GACTATCAATC
CGACTATTAGT -> GACTATTAGTG
CGACTGATATT -> GACTGATATTT
CGAGAATCTCG -> GAGAATCTCGT
CGAGACCTCAC -> GAGACCTCACA
CGAGGAACGGC -> GAGGAACGGCA
CGAGGATGCCG -> GAGGATGCCGC
CGAGGCACAAT -> GAGGCACAATA
CGAGTCCCCAC -> GAGTCCCCACG
CGAGTCGACTG -> GAGTCGACTGA
CGATAACGCCA -> GATAACGCCAA
CGATCCCGAGG -> GATCCCGAGGC
CGATCCTGGCT -> GATCCTGGCTG
CGATCTAATGG -> GATCTAATGGC
CGATCTGTGTT -> GATCTGTGTTG
CGATTCAAATT -> GATTCAAATTT
CGATTGCCGTG -> GATTGCCGTGT
CGCAACGGCTT -> GCAACGGCTTA
CGCAAGTTGCG -> GCAAGTTGCGC
CGCAAGTTTTT -> GCAAGTTTTTG
CGCAATCTGCC -> GCAATCTGCCC
CGCAATTATCT -> GCAATTATCTC
CGCAGAGTTTT -> GCAGAGTTTTG
CGCAGGAGACA -> GCAGGAGACAC
CGCATACGGTG -> GCATACGGTGT
CGCATATGACC -> GCATATGACCG
CGCATGATTAA -> GCATGATTAAC
CGCATGCGCGT -> GCATGCGCGTG
CGCATGTACCG -> GCATGTACCGG
CGCCAAAGCAT -> GCCAAAGCATT
CGCCACCTTAC -> GCCACCTTACA
CGCCACGTTGA -> GCCACGTTGAC
CGCCAGCCATT -> GCCAGCCATTG
CGCCAGGTTAT -> GCCAGGTTATC
CGCCCGTGGAT -> GCCCGTGGATG
CGCCGACGTTT -> GCCGACGTTTT
CGCCTGTCATA -> GCCTGTCATAG
CGCCTTCTGCT -> GCCTTCTGCTG
CGCGAAGGCAC -> GCGAAGGCACA
CGCGACTATCA -> GCGACTATCAA
CGCGAGGATGC -> GCGAGGATGCC
CGCGCCTGTCA -> GCGCCTGTCAT
CGCGCTAACGA -> GCGCTAACGAC
CGCGCTCGCGA -> GCGCTCGCGAC
CGCGTGATAGG -> GCGTGATAGGC
CGCTAACGACT -> GCTAACGACTA
CGCTAAGCCGC -> GCTAAGCCGCA
CGCTAAGCGCA -> GCTAAGCGCAT
CGCTAATCTCC -> GCTAATCTCCC
CGCTAGCGCCA -> GCTAGCGCCAC
CGCTCCCAGTC -> GCTCCCAGTCA
CGCTCCTACCG -> GCTCCTACCGC
CGCTCGCGACT -> GCTCGCGACTA
CGCTCTTCGTT -> GCTCTTCGTTT
CGCTGCCCACC -> GCTGCCCACCA
CGCTGGTTGAT -> GCTGGTTGATT
CGCTTAGCTTC -> GCTTAGCTTCT
CGCTTTGGGTA -> GCTTTGGGTAG
CGGAAAGAAGC -> GGAAAGAAGCA
CGGAACCCCCT -> GGAACCCCCTA
CGGAACTGAGG -> GGAACTGAGGT
CGGACACCAAA -> GGACACCAAAA
CGGACGTGCTA -> GGACGTGCTAG
CGGACTTACGG -> GGACTTACGGT
CGGAGGGTGAG -> GGAGGGTGAGG
CGGATATGGTA -> GGATATGGTAC
CGGATTACTGT -> GGATTACTGTG
CGGCAGTTTTT -> GGCAGTTTTTC
CGGCCCCAAAT -> GGCCCCAAATA
CGGCCGCAGAG -> GGCCGCAGAGT
CGGCGACATGT -> GGCGACATGTT
CGGCGTCACGA -> GGCGTCACGAT
CGGCTACTTAC -> GGCTACTTACA
CGGCTTACGAA -> GGCTTACGAAA
CGGGACGGAAA -> GGGACGGAAAG
CGGGAGACAGT -> GGGAGACAGTA
CGGGGAAGCGG -> GGGGAAGCGGT
CGGGGCGAGAC -> GGGGCGAGACC
CGGGGGCTCTG -> GGGGGCTCTGG
CGGGTCTAGAG -> GGGTCTAGAGG
CGGGTGAAGTT -> GGGTGAAGTTC
CGGTAACTGCA -> GGTAACTGCAA
CGGTATATGGA -> GGTATATGGAG
CGGTCAAAGCT -> GGTCAAAGCTC
CGGTCGCTAAG -> GGTCGCTAAGC
CGGTCGCTAGC -> GGTCGCTAGCG
CGGTGCCCCGC -> GGTGCCCCGCA
CGGTGGCTACT -> GGTGGCTACTA
CGGTGTCTCGG -> GGTGTCTCGGA
CGGTTAATTCA -> GGTTAATTCAC
CGGTTACCACC -> GGTTACCACCG
CGGTTATTGCC -> GGTTATTGCCA
CGGTTCGCATG -> GGTTCGCATGA
CGTAAGTTCAC -> GTAAGTTCACA
CGTAGGCTAGT -> GTAGGCTAGTT
CGTATAATGCG -> GTATAATGCGT
CGTATCCTGTA -> GTATCCTGTAT
CGTCACGATAA -> GTCACGATAAC
CGTCGAAAAGA -> GTCGAAAAGAC
CGTCGAAAAGC -> GTCGAAAAGCG
CGTCGCCGACG -> GTCGCCGACGT
CGTCGCTTTGG -> GTCGCTTTGGG
CGTGATAGGCC -> GTGATAGGCCA
CGTGCACACAA -> GTGCACACAAC
CGTGCTAGCAA -> GTGCTAGCAAA
CGTGGATGGCG -> GTGGATGGCGA
CGTGGCACCCA -> GTGGCACCCAG
CGTGGTCAGTT -> GTGGTCAGTTG
CGTGTAAACAT -> GTGTAAACATC
CGTGTGCAGGG -> GTGTGCAGGGA
CGTTCACATGC -> GTTCACATGCT
CGTTCTTAAGT -> GTTCTTAAGTG
CGTTCTTCATT -> GTTCTTCATTT
CGTTGACAGTC -> GTTGACAGTCG
CGTTGTGTTGC -> GTTGTGTTGCG
CGTTTACCGGG -> GTTTACCGGGG
CGTTTACTCCA -> GTTTACTCCAG
CGTTTGGTCCG -> GTTTGGTCCGG
CGTTTTCGTAT -> GTTTTCGTATC
CGTTTTCTATT -> GTTTTCTATTA
CGTTTTTTCCC -> GTTTTTTCCCA
CTAAAGCCTAC -> TAAAGCCTACC
CTAACATCTTG -> TAACATCTTGC
CTAACGACTAT -> TAACGACTATT
CTAAGATACGA -> TAAGATACGAT
CTAAGCCGCAA -> TAAGCCGCAAT
CTAAGCGCATG -> TAAGCGCATGC
CTAAGCTACAC -> TAAGCTACACG
CTAAGTCCGTC -> TAAGTCCGTCG
CTAATCTCCCA -> TAATCTCCCAT
CTAATGGCGTT -> TAATGGCGTTT
CTACAAGGCCC -> TACAAGGCCCG
CTACACGGGAG -> TACACGGGAGA
CTACCCACGGC -> TACCCACGGCT
CTACCGCTCTT -> TACCGCTCTTC
CTACTATATGC -> TACTATATGCG
CTACTCATCGA -> TACTCATCGAT
CTACTTACATC -> TACTTACATCG
CTAGAGGAACC -> TAGAGGAACCT
CTAGATAATTA -> TAGATAATTAT
CTAGCAAACTC -> TAGCAAACTCC
CTAGCACGTTT -> TAGCACGTTTA
CTAGCGCCACC -> TAGCGCCACCT
CTAGGCAGATT -> TAGGCAGATTT
CTAGTCAATCA -> TAGTCAATCAA
CTAGTCAGCTC -> TAGTCAGCTCT
CTAGTTGAGGT -> TAGTTGAGGTA
CTATAGGTATT -> TATAGGTATTG
CTATATGCGCT -> TATATGCGCTC
CTATCAATCCA -> TATCAATCCAC
CTATGTTTTGG -> TATGTTTTGGA
CTATTAGGTGT -> TATTAGGTGTC
CTATTAGTGAT -> TATTAGTGATT
CTATTCAGCGG -> TATTCAGCGGC
CTCACACACAG -> TCACACACAGG
CTCACGTTCTT -> TCACGTTCTTC
CTCAGTTCTCT -> TCAGTTCTCTT
CTCATCGATTG -> TCATCGATTGC
CTCCAAAATGC -> TCCAAAATGCG
CTCCAAACCTT -> TCCAAACCTTC
CTCCAGAGAGG -> TCCAGAGAGGG
CTCCATGACAG -> TCCATGACAGC
CTCCCAGTCAG -> TCCCAGTCAGG
CTCCCATATAG -> TCCCATATAGT
CTCCCCCTAAG -> TCCCCCTAAGT
CTCCGACGCCA -> TCCGACGCCAC
CTCCGTGTGCA -> TCCGTGTGCAG
CTCCTACCGCT -> TCCTACCGCTC
CTCCTATGTTT -> TCCTATGTTTT
CTCCTCCTATG -> TCCTCCTATGT
CTCCTCCTCCT -> TCCTCCTCCTA
CTCCTGTTACC -> TCCTGTTACCT
CTCCTTACGGA -> TCCTTACGGAC
CTCGCCAGGTT -> TCGCCAGGTTA
CTCGCCCGTGG -> TCGCCCGTGGA
CTCGCGACTAT -> TCGCGACTATC
CTCGGAACCCC -> TCGGAACCCCC
CTCGGACACCA -> TCGGACACCAA
CTCGGATATGG -> TCGGATATGGT
CTCGGGTGAAG -> TCGGGTGAAGT
CTCGTATAATG -> TCGTATAATGC
CTCTAACATCT -> TCTAACATCTT
CTCTAGATAAT -> TCTAGATAATT
CTCTCCTGTTA -> TCTCCTGTTAC
CTCTCTAGATA -> TCTCTAGATAA
CTCTGGGGCCG -> TCTGGGGCCGC
CTCTTAACCAC -> TCTTAACCACT
CTCTTATCTAC -> TCTTATCTACT
CTCTTCGTTTG -> TCTTCGTTTGG
CTGAAATGCCC -> TGAAATGCCCC
CTGACTGGGTG -> TGACTGGGTGG
CTGAGCAACGG -> TGAGCAACGGG
CTGAGGTCCAC -> TGAGGTCCACG
CTGATATTTTC -> TGATATTTTCT
CTGATGTGATC -> TGATGTGATCT
CTGCAAGTGCG -> TGCAAGTGCGC
CTGCCCACCAG -> TGCCCACCAGC
CTGCCCGGGGG -> TGCCCGGGGGC
CTGCCGTAGGC -> TGCCGTAGGCT
CTGCGGAACTG -> TGCGGAACTGA
CTGCTGGTTAA -> TGCTGGTTAAC
CTGGATACTCC -> TGGATACTCCA
CTGGCAGCAGC -> TGGCAGCAGCG
CTGGCTGATGT -> TGGCTGATGTG
CTGGCTTGTCA -> TGGCTTGTCAT
CTGGGGCCGCG -> TGGGGCCGCGC
CTGGGTCTTCC -> TGGGTCTTCCA
CTGGGTGGACG -> TGGGTGGACGC
CTGGTACCTAA -> TGGTACCTAAG
CTGGTTAACCT -> TGGTTAACCTG
CTGGTTGATTC -> TGGTTGATTCA
CTGTACCAGGT -> TGTACCAGGTA
CTGTATAGAAT -> TGTATAGAATG
CTGTCATAGGA -> TGTCATAGGAC
CTGTCCGCTCC -> TGTCCGCTCCT
CTGTGGGATGA -> TGTGGGATGAC
CTGTGTTGACC -> TGTGTTGACCC
CTGTTACCTAT -> TGTTACCTATA
CTGTTTACCGC -> TGTTTACCGCT
CTGTTTGGTTG -> TGTTTGGTTGA
CTTAACCACTC -> TTAACCACTCG
CTTAAGTGTTC -> TTAAGTGTTCC
CTTACATCCCA -> TTACATCCCAT
CTTACATCGCT -> TTACATCGCTG
CTTACGAAAAA -> TTACGAAAAAT
CTTACGGACGT -> TTACGGACGTG
CTTACGGTTAT -> TTACGGTTATT
CTTAGCTTCTT -> TTAGCTTCTTG
CTTAGGCTCTA -> TTAGGCTCTAA
CTTATCTACTC -> TTATCTACTCA
CTTCATTTCCT -> TTCATTTCCTG
CTTCATTTGAC -> TTCATTTGACA
CTTCCAAAGTA -> TTCCAAAGTAT
CTTCGTTTGGT -> TTCGTTTGGTC
CTTCTGCTGGT -> TTCTGCTGGTT
CTTCTTAGGCT -> TTCTTAGGCTC
CTTCTTGGTAC -> TTCTTGGTACT
CTTCTTTTCCC -> TTCTTTTCCCA
CTTGAGGAACC -> TTGAGGAACCA
CTTGCCGGTGG -> TTGCCGGTGGC
CTTGGTACTGG -> TTGGTACTGGG
CTTGTCATTAA -> TTGTCATTAAC
CTTGTCGTGGC -> TTGTCGTGGCA
CTTTGGGTAGT -> TTTGGGTAGTA
CTTTGTCTAAG -> TTTGTCTAAGA
CTTTTCCCACG -> TTTTCCCACGC
GAAAAATAAGC -> AAAAATAAGCG
GAAAAGACGGA -> AAAAGACGGAC
GAAAAGCGGTG -> AAAAGCGGTGC
GAAAATGTCCT -> AAAATGTCCTC
GAAACCGCAAG -> AAACCGCAAGT
GAAAGAAGCAG -> AAAGAAGCAGC
GAAAGTCATAT -> AAAGTCATATC
GAAATGCCCCC -> AAATGCCCCCC
GAACCATAAGA -> AACCATAAGAT
GAACCCCCTAG -> AACCCCCTAGG
GAACCTTCTTA -> AACCTTCTTAG
GAACGAGGAAC -> AACGAGGAACG
GAACGGCAGTT -> AACGGCAGTTT
GAACGTTCTTA -> AACGTTCTTAA
GAACTCCGACG -> AACTCCGACGC
GAACTGAGGTC -> AACTGAGGTCC
GAACTGGTACC -> AACTGGTACCT
GAAGCAGCCAA -> AAGCAGCCAAT
GAAGCGGTATA -> AAGCGGTATAT
GAAGGAGCGAT -> AAGGAGCGATC
GAAGGAGTCAA -> AAGGAGTCAAT
GAAGGCACACA -> AAGGCACACAT
GAAGTTCACCA -> AAGTTCACCAG
GAATCGGGACG -> AATCGGGACGG
GAATCTCGTAT -> AATCTCGTATA
GAATGAGTTTT -> AATGAGTTTTA
GAATTTAACCT -> AATTTAACCTG
GACACATTTTG -> ACACATTTTGT
GACACCAAAAG -> ACACCAAAAGT
GACACGCAACG -> ACACGCAACGG
GACAGCGCTGG -> ACAGCGCTGGT
GACAGTACATA -> ACAGTACATAT
GACAGTCGTAA -> ACAGTCGTAAG
GACATGTTTTA -> ACATGTTTTAC
GACCCGTGGTC -> ACCCGTGGTCA
GACCGCAGGAG -> ACCGCAGGAGA
GACCGGGGAAG -> ACCGGGGAAGC
GACCTCACACA -> ACCTCACACAC
GACGCCACGTT -> ACGCCACGTTG
GACGCCTTCTG -> ACGCCTTCTGC
GACGGAAAGAA -> ACGGAAAGAAG
GACGGACTTAC -> ACGGACTTACG
GACGTCGCCGA -> ACGTCGCCGAC
GACGTCGCTTT -> ACGTCGCTTTG
GACGTGCTAGC -> ACGTGCTAGCA
GACGTTTTCTA -> ACGTTTTCTAT
GACTAAAGCCT -> ACTAAAGCCTA
GACTATCAATC -> ACTATCAATCC
GACTATTAGTG -> ACTATTAGTGA
GACTGATATTT -> ACTGATATTTT
GACTGGGTGGA -> ACTGGGTGGAC
GACTGTTTGGT -> ACTGTTTGGTT
GACTTACGGTT -> ACTTACGGTTA
GAGAATCTCGT -> AGAATCTCGTA
GAGACACATTT -> AGACACATTTT
GAGACAGTACA -> AGACAGTACAT
GAGACCTCACA -> AGACCTCACAC
GAGAGGGAAGG -> AGAGGGAAGGA
GAGCAACGGGT -> AGCAACGGGTC
GAGCGATCCTG -> AGCGATCCTGG
GAGGAACCATA -> AGGAACCATAA
GAGGAACCTTC -> AGGAACCTTCT
GAGGAACGGCA -> AGGAACGGCAG
GAGGAATTTAA -> AGGAATTTAAC
GAGGATGCCGC -> AGGATGCCGCG
GAGGCACAATA -> AGGCACAATAC
GAGGGAAGGAG -> AGGGAAGGAGC
GAGGGTGAGGC -> AGGGTGAGGCC
GAGGGTGCGCA -> AGGGTGCGCAT
GAGGTAACACA -> AGGTAACACAT
GAGGTCCACGG -> AGGTCCACGGT
GAGGTTGGGAA -> AGGTTGGGAAC
GAGTCAATCTA -> AGTCAATCTAC
GAGTCCCCACG -> AGTCCCCACGA
GAGTCGACTGA -> AGTCGACTGAT
GAGTCTGCGGA -> AGTCTGCGGAA
GAGTTTTACCC -> AGTTTTACCCA
GAGTTTTGCAG -> AGTTTTGCAGC
GATAAATATAC -> ATAAATATACC
GATAACGCCAA -> ATAACGCCAAA
GATAATTATCA -> ATAATTATCAC
GATACGATCTG -> ATACGATCTGT
GATACTCCATG -> ATACTCCATGA
GATAGGCCAAT -> ATAGGCCAATC
GATATGGTACG -> ATATGGTACGA
GATATTTTCTC -> ATATTTTCTCA
GATCCCGAGGC -> ATCCCGAGGCA
GATCCTGGCTG -> ATCCTGGCTGA
GATCTAATGGC -> ATCTAATGGCG
GATCTCCTCCT -> ATCTCCTCCTC
GATCTGTGTTG -> ATCTGTGTTGA
GATGACGTCGC -> ATGACGTCGCC
GATGCCGCGCT -> ATGCCGCGCTC
GATGGCGACTA -> ATGGCGACTAA
GATGTGATCTC -> ATGTGATCTCC
GATTAACCAAG -> ATTAACCAAGT
GATTAAGGCGA -> ATTAAGGCGAT
GATTACTGTGG -> ATTACTGTGGG
GATTCAAATTT -> ATTCAAATTTG
GATTCAATGCG -> ATTCAATGCGA
GATTGCCGTGT -> ATTGCCGTGTA
GATTTAAGAAC -> ATTTAAGAACG
GATTTGATAAA -> ATTTGATAAAT
GCAAACTCCAA -> CAAACTCCAAA
GCAACGGCTTA -> CAACGGCTTAC
GCAACGGGTCT -> CAACGGGTCTA
GCAAGTGCGCG -> CAAGTGCGCGC
GCAAGTTGCGC -> CAAGTTGCGCG
GCAAGTTTTTG -> CAAGTTTTTGC
GCAATCTGCCC -> CAATCTGCCCG
GCAATTATCTC -> CAATTATCTCA
GCACAATACTG -> CACAATACTGC
GCACACAACGC -> CACACAACGCA
GCACACATGCC -> CACACATGCCG
GCACCCAGGTG -> CACCCAGGTGC
GCACGCATATG -> CACGCATATGA
GCACGTTTACT -> CACGTTTACTC
GCAGAGTTTTG -> CAGAGTTTTGC
GCAGATTTAAG -> CAGATTTAAGA
GCAGCACGCAT -> CAGCACGCATA
GCAGCAGCGGA -> CAGCAGCGGAG
GCAGCCAATCC -> CAGCCAATCCC
GCAGCGGAGGG -> CAGCGGAGGGT
GCAGGAGACAC -> CAGGAGACACA
GCAGGGAAACC -> CAGGGAAACCG
GCAGTTTTTCG -> CAGTTTTTCGT
GCATACGGTGT -> CATACGGTGTC
GCATATGACCG -> CATATGACCGG
GCATGATTAAC -> CATGATTAACC
GCATGCGCGTG -> CATGCGCGTGA
GCATGTACCGG -> CATGTACCGGA
GCATTCTTGAG -> CATTCTTGAGG
GCCAAAGCATT -> CCAAAGCATTC
GCCAATCCCTC -> CCAATCCCTCG
GCCAATCGATC -> CCAATCGATCT
GCCAATCGCCA -> CCAATCGCCAG
GCCAATTCCCC -> CCAATTCCCCA
GCCAATTGCTC -> CCAATTGCTCC
GCCACCTTACA -> CCACCTTACAT
GCCACGTTGAC -> CCACGTTGACA
GCCAGCCATTG -> CCAGCCATTGT
GCCAGGTTATC -> CCAGGTTATCA
GCCATCGGCGT -> CCATCGGCGTC
GCCATTGTAGC -> CCATTGTAGCC
GCCCACCAGCC -> CCCACCAGCCA
GCCCCAAATAA -> CCCCAAATAAA
GCCCCCCTCGC -> CCCCCCTCGCC
GCCCCGCATGT -> CCCCGCATGTA
GCCCGATCCCG -> CCCGATCCCGA
GCCCGGGGGCT -> CCCGGGGGCTC
GCCCGTGGATG -> CCCGTGGATGG
GCCGACGTTTT -> CCGACGTTTTC
GCCGCAATCTG -> CCGCAATCTGC
GCCGCAGAGTT -> CCGCAGAGTTT
GCCGCGCCTGT -> CCGCGCCTGTC
GCCGCGCTCGC -> CCGCGCTCGCG
GCCGGTGGCTA -> CCGGTGGCTAC
GCCGTAGGCTA -> CCGTAGGCTAG
GCCGTGCACAC -> CCGTGCACACA
GCCGTGTAAAC -> CCGTGTAAACA
GCCTACCCACG -> CCTACCCACGG
GCCTCGGAACC -> CCTCGGAACCC
GCCTCTCCTGT -> CCTCTCCTGTT
GCCTCTTAACC -> CCTCTTAACCA
GCCTGTCATAG -> CCTGTCATAGG
GCCTTCTGCTG -> CCTTCTGCTGG
GCCTTGTCGTG -> CCTTGTCGTGG
GCGAAGGCACA -> CGAAGGCACAC
GCGACATGTTT -> CGACATGTTTT
GCGACTAAAGC -> CGACTAAAGCC
GCGACTATCAA -> CGACTATCAAT
GCGAGACCTCA -> CGAGACCTCAC
GCGAGGATGCC -> CGAGGATGCCG
GCGAGTCGACT -> CGAGTCGACTG
GCGATCCTGGC -> CGATCCTGGCT
GCGATTCAAAT -> CGATTCAAATT
GCGCATACGGT -> CGCATACGGTG
GCGCATGCGCG -> CGCATGCGCGT
GCGCCACCTTA -> CGCCACCTTAC
GCGCCTGTCAT -> CGCCTGTCATA
GCGCGAGGATG -> CGCGAGGATGC
GCGCGCTAACG -> CGCGCTAACGA
GCGCGTGATAG -> CGCGTGATAGG
GCGCTAACGAC -> CGCTAACGACT
GCGCTAAGCCG -> CGCTAAGCCGC
GCGCTAATCTC -> CGCTAATCTCC
GCGCTCCCAGT -> CGCTCCCAGTC
GCGCTCGCGAC -> CGCTCGCGACT
GCGCTGGTTGA -> CGCTGGTTGAT
GCGGAACTGAG -> CGGAACTGAGG
GCGGAGGGTGA -> CGGAGGGTGAG
GCGGCCCCAAA -> CGGCCCCAAAT
GCGGTATATGG -> CGGTATATGGA
GCGGTCAAAGC -> CGGTCAAAGCT
GCGGTCGCTAA -> CGGTCGCTAAG
GCGGTCGCTAG -> CGGTCGCTAGC
GCGGTGCCCCG -> CGGTGCCCCGC
GCGTCACGATA -> CGTCACGATAA
GCGTGATAGGC -> CGTGATAGGCC
GCGTTGTGTTG -> CGTTGTGTTGC
GCGTTTACCGG -> CGTTTACCGGG
GCGTTTTCGTA -> CGTTTTCGTAT
GCTAACGACTA -> CTAACGACTAT
GCTAAGCCGCA -> CTAAGCCGCAA
GCTAAGCGCAT -> CTAAGCGCATG
GCTAATCTCCC -> CTAATCTCCCA
GCTACACGGGA -> CTACACGGGAG
GCTACTATATG -> CTACTATATGC
GCTACTTACAT -> CTACTTACATC
GCTAGCAAACT -> CTAGCAAACTC
GCTAGCGCCAC -> CTAGCGCCACC
GCTAGTCAATC -> CTAGTCAATCA
GCTAGTTGAGG -> CTAGTTGAGGT
GCTCCCAGTCA -> CTCCCAGTCAG
GCTCCCCCTAA -> CTCCCCCTAAG
GCTCCGTGTGC -> CTCCGTGTGCA
GCTCCTACCGC -> CTCCTACCGCT
GCTCGCGACTA -> CTCGCGACTAT
GCTCGGGTGAA -> CTCGGGTGAAG
GCTCTAACATC -> CTCTAACATCT
GCTCTCTAGAT -> CTCTCTAGATA
GCTCTGGGGCC -> CTCTGGGGCCG
GCTCTTCGTTT -> CTCTTCGTTTG
GCTGATGTGAT -> CTGATGTGATC
GCTGCCCACCA -> CTGCCCACCAG
GCTGGCAGCAG -> CTGGCAGCAGC
GCTGGTTAACC -> CTGGTTAACCT
GCTGGTTGATT -> CTGGTTGATTC
GCTTACGAAAA -> CTTACGAAAAA
GCTTAGCTTCT -> CTTAGCTTCTT
GCTTCTTGGTA -> CTTCTTGGTAC
GCTTGTCATTA -> CTTGTCATTAA
GCTTTGGGTAG -> CTTTGGGTAGT
GGAAACCGCAA -> GAAACCGCAAG
GGAAAGAAGCA -> GAAAGAAGCAG
GGAACCATAAG -> GAACCATAAGA
GGAACCCCCTA -> GAACCCCCTAG
GGAACCTTCTT -> GAACCTTCTTA
GGAACGAGGAA -> GAACGAGGAAC
GGAACGGCAGT -> GAACGGCAGTT
GGAACTCCGAC -> GAACTCCGACG
GGAACTGAGGT -> GAACTGAGGTC
GGAACTGGTAC -> GAACTGGTACC
GGAAGCGGTAT -> GAAGCGGTATA
GGAAGGAGCGA -> GAAGGAGCGAT
GGAATTTAACC -> GAATTTAACCT
GGACACCAAAA -> GACACCAAAAG
GGACGCCTTCT -> GACGCCTTCTG
GGACGGAAAGA -> GACGGAAAGAA
GGACGTCGCTT -> GACGTCGCTTT
GGACGTGCTAG -> GACGTGCTAGC
GGACTGTTTGG -> GACTGTTTGGT
GGACTTACGGT -> GACTTACGGTT
GGAGACACATT -> GAGACACATTT
GGAGACAGTAC -> GAGACAGTACA
GGAGCGATCCT -> GAGCGATCCTG
GGAGGAATTTA -> GAGGAATTTAA
GGAGGGTGAGG -> GAGGGTGAGGC
GGAGGGTGCGC -> GAGGGTGCGCA
GGAGTCAATCT -> GAGTCAATCTA
GGATACTCCAT -> GATACTCCATG
GGATATGGTAC -> GATATGGTACG
GGATGACGTCG -> GATGACGTCGC
GGATGCCGCGC -> GATGCCGCGCT
GGATGGCGACT -> GATGGCGACTA
GGATTACTGTG -> GATTACTGTGG
GGCACAATACT -> GCACAATACTG
GGCACACATGC -> GCACACATGCC
GGCACCCAGGT -> GCACCCAGGTG
GGCAGATTTAA -> GCAGATTTAAG
GGCAGCAGCGG -> GCAGCAGCGGA
GGCAGTTTTTC -> GCAGTTTTTCG
GGCCAATCGCC -> GCCAATCGCCA
GGCCCCAAATA -> GCCCCAAATAA
GGCCCGATCCC -> GCCCGATCCCG
GGCCGCAGAGT -> GCCGCAGAGTT
GGCCGCGCCTG -> GCCGCGCCTGT
GGCCTCGGAAC -> GCCTCGGAACC
GGCGACATGTT -> GCGACATGTTT
GGCGACTAAAG -> GCGACTAAAGC
GGCGAGACCTC -> GCGAGACCTCA
GGCGATTCAAA -> GCGATTCAAAT
GGCGTCACGAT -> GCGTCACGATA
GGCGTTTACCG -> GCGTTTACCGG
GGCGTTTTCGT -> GCGTTTTCGTA
GGCTACTATAT -> GCTACTATATG
GGCTACTTACA -> GCTACTTACAT
GGCTAGTTGAG -> GCTAGTTGAGG
GGCTCTAACAT -> GCTCTAACATC
GGCTCTGGGGC -> GCTCTGGGGCC
GGCTGATGTGA -> GCTGATGTGAT
GGCTTACGAAA -> GCTTACGAAAA
GGCTTGTCATT -> GCTTGTCATTA
GGGAAACCGCA -> GGAAACCGCAA
GGGAACTCCGA -> GGAACTCCGAC
GGGAAGCGGTA -> GGAAGCGGTAT
GGGAAGGAGCG -> GGAAGGAGCGA
GGGACGGAAAG -> GGACGGAAAGA
GGGAGACAGTA -> GGAGACAGTAC
GGGAGGAATTT -> GGAGGAATTTA
GGGATGACGTC -> GGATGACGTCG
GGGCCGCGCCT -> GGCCGCGCCTG
GGGCGAGACCT -> GGCGAGACCTC
GGGCTCTGGGG -> GGCTCTGGGGC
GGGGAAGCGGT -> GGGAAGCGGTA
GGGGCCGCGCC -> GGGCCGCGCCT
GGGGCGAGACC -> GGGCGAGACCT
GGGGCTCTGGG -> GGGCTCTGGGG
GGGGGCTCTGG -> GGGGCTCTGGG
GGGTAGTAGGA -> GGTAGTAGGAA
GGGTCTAGAGG -> GGTCTAGAGGA
GGGTCTTCCAA -> GGTCTTCCAAA
GGGTGAAGTTC -> GGTGAAGTTCA
GGGTGCGCATA -> GGTGCGCATAC
GGGTGGACGCC -> GGTGGACGCCT
GGTAACACATC -> GTAACACATCA
GGTAACTGCAA -> GTAACTGCAAG
GGTACCTAAGC -> GTACCTAAGCT
GGTACGAAGGA -> GTACGAAGGAG
GGTACTGGGTC -> GTACTGGGTCT
GGTAGCCAATT -> GTAGCCAATTG
GGTAGTAGGAA -> GTAGTAGGAAC
GGTATATGGAG -> GTATATGGAGG
GGTATTGAGTC -> GTATTGAGTCT
GGTCAAAGCTC -> GTCAAAGCTCG
GGTCAACTGTT -> GTCAACTGTTT
GGTCAGTTGGT -> GTCAGTTGGTG
GGTCCACGGTA -> GTCCACGGTAA
GGTCCGGTTAC -> GTCCGGTTACC
GGTCGCTAAGC -> GTCGCTAAGCG
GGTCGCTAGCG -> GTCGCTAGCGC
GGTCTAGAGGA -> GTCTAGAGGAA
GGTCTTCCAAA -> GTCTTCCAAAG
GGTGAAGTTCA -> GTGAAGTTCAC
GGTGCCCCGCA -> GTGCCCCGCAT
GGTGCGCATAC -> GTGCGCATACG
GGTGCGGTCGC -> GTGCGGTCGCT
GGTGCTGGCAG -> GTGCTGGCAGC
GGTGGACGCCT -> GTGGACGCCTT
GGTGGCTACTA -> GTGGCTACTAT
GGTGTCAGTAT -> GTGTCAGTATC
GGTGTCTCGGA -> GTGTCTCGGAT
GGTTAACCTGG -> GTTAACCTGGA
GGTTAATTCAC -> GTTAATTCACC
GGTTACCACCG -> GTTACCACCGA
GGTTATCAGAG -> GTTATCAGAGG
GGTTATTGCCA -> GTTATTGCCAA
GGTTCGCATGA -> GTTCGCATGAT
GGTTGAAAGTC -> GTTGAAAGTCA
GGTTGATTCAA -> GTTGATTCAAT
GGTTGGGAACT -> GTTGGGAACTC
GTAAACATCAT -> TAAACATCATG
GTAACACATCA -> TAACACATCAT
GTAACTGCAAG -> TAACTGCAAGT
GTAAGTTCACA -> TAAGTTCACAA
GTAATGAAAAT -> TAATGAAAATG
GTACATATCGC -> TACATATCGCG
GTACCAGGTAG -> TACCAGGTAGC
GTACCGGATTA -> TACCGGATTAC
GTACCTAAGCT -> TACCTAAGCTA
GTACGAAGGAG -> TACGAAGGAGT
GTACTGGGTCT -> TACTGGGTCTT
GTAGCCAATTG -> TAGCCAATTGC
GTAGCCTCTCC -> TAGCCTCTCCT
GTAGGAACTGG -> TAGGAACTGGT
GTAGGCTAGTT -> TAGGCTAGTTG
GTAGTAGGAAC -> TAGTAGGAACT
GTATAAGGCGT -> TATAAGGCGTT
GTATAATGCGT -> TATAATGCGTT
GTATAGAATGA -> TATAGAATGAG
GTATATCCGGC -> TATATCCGGCC
GTATATGGAGG -> TATATGGAGGG
GTATCCTGTAT -> TATCCTGTATA
GTATCCTTTGT -> TATCCTTTGTC
GTATTGAGTCT -> TATTGAGTCTG
GTCAAAGCTCG -> TCAAAGCTCGG
GTCAACTGTTT -> TCAACTGTTTA
GTCAATCAATA -> TCAATCAATAC
GTCAATCTACA -> TCAATCTACAA
GTCACGATAAC -> TCACGATAACG
GTCAGCTCTCT -> TCAGCTCTCTA
GTCAGGACGTC -> TCAGGACGTCG
GTCAGTAATGA -> TCAGTAATGAA
GTCAGTATCCT -> TCAGTATCCTT
GTCAGTTGGTG -> TCAGTTGGTGC
GTCATAGGACT -> TCATAGGACTG
GTCATATCCTA -> TCATATCCTAG
GTCATTAACGT -> TCATTAACGTT
GTCCACGGTAA -> TCCACGGTAAC
GTCCCCACGAC -> TCCCCACGACC
GTCCGCTCCTA -> TCCGCTCCTAC
GTCCGGTTACC -> TCCGGTTACCA
GTCCGTCGAAA -> TCCGTCGAAAA
GTCCTCCAAAC -> TCCTCCAAACC
GTCGAAAAGAC -> TCGAAAAGACG
GTCGAAAAGCG -> TCGAAAAGCGG
GTCGACTGATA -> TCGACTGATAT
GTCGCCGACGT -> TCGCCGACGTT
GTCGCTAAGCG -> TCGCTAAGCGC
GTCGCTAGCGC -> TCGCTAGCGCC
GTCGCTTTGGG -> TCGCTTTGGGT
GTCGGCGACAT -> TCGGCGACATG
GTCGTAAGTTC -> TCGTAAGTTCA
GTCGTGGCACC -> TCGTGGCACCC
GTCTAAGATAC -> TCTAAGATACG
GTCTAGAGGAA -> TCTAGAGGAAC
GTCTCGGATAT -> TCTCGGATATG
GTCTGCGGAAC -> TCTGCGGAACT
GTCTTCCAAAG -> TCTTCCAAAGT
GTGAAGTTCAC -> TGAAGTTCACC
GTGATAGGCCA -> TGATAGGCCAA
GTGATCTCCTC -> TGATCTCCTCC
GTGATTAAGGC -> TGATTAAGGCG
GTGCACACAAC -> TGCACACAACG
GTGCAGGGAAA -> TGCAGGGAAAC
GTGCCCCGCAT -> TGCCCCGCATG
GTGCCTTGTCG -> TGCCTTGTCGT
GTGCGCATACG -> TGCGCATACGG
GTGCGCGCTAA -> TGCGCGCTAAC
GTGCGCTAAGC -> TGCGCTAAGCC
GTGCGGTCGCT -> TGCGGTCGCTA
GTGCTAGCAAA -> TGCTAGCAAAC
GTGCTAGTCAA -> TGCTAGTCAAT
GTGCTGGCAGC -> TGCTGGCAGCA
GTGGACGCCTT -> TGGACGCCTTC
GTGGATGGCGA -> TGGATGGCGAC
GTGGCACCCAG -> TGGCACCCAGG
GTGGCTACTAT -> TGGCTACTATA
GTGGGATGACG -> TGGGATGACGT
GTGGTCAGTTG -> TGGTCAGTTGG
GTGTAAACATC -> TGTAAACATCA
GTGTCAGTATC -> TGTCAGTATCC
GTGTCTCGGAT -> TGTCTCGGATA
GTGTGCAGGGA -> TGTGCAGGGAA
GTGTGCGCTAA -> TGTGCGCTAAG
GTGTTCCTGTA -> TGTTCCTGTAC
GTGTTGACCCG -> TGTTGACCCGT
GTGTTGCGGTC -> TGTTGCGGTCG
GTTAACCTGGA -> TTAACCTGGAT
GTTAATTCACC -> TTAATTCACCA
GTTACCACCGA -> TTACCACCGAG
GTTACCTATAG -> TTACCTATAGG
GTTATCAGAGG -> TTATCAGAGGT
GTTATTGCCAA -> TTATTGCCAAT
GTTCAAACTGA -> TTCAAACTGAG
GTTCACAAAAG -> TTCACAAAAGG
GTTCACATGCT -> TTCACATGCTC
GTTCACCAGAA -> TTCACCAGAAT
GTTCCTGTACC -> TTCCTGTACCA
GTTCGCATGAT -> TTCGCATGATT
GTTCTCTTATC -> TTCTCTTATCT
GTTCTTAAGTG -> TTCTTAAGTGT
GTTCTTCATTT -> TTCTTCATTTC
GTTGAAAGTCA -> TTGAAAGTCAT
GTTGACAGTCG -> TTGACAGTCGT
GTTGACCCGTG -> TTGACCCGTGG
GTTGAGGTAAC -> TTGAGGTAACA
GTTGATTCAAT -> TTGATTCAATG
GTTGCGCGAGG -> TTGCGCGAGGA
GTTGCGGTCGC -> TTGCGGTCGCT
GTTGGGAACTC -> TTGGGAACTCC
GTTGGTGCTGG -> TTGGTGCTGGC
GTTGTGTTGCG -> TTGTGTTGCGG
GTTTACCGCTT -> TTTACCGCTTA
GTTTACCGGGG -> TTTACCGGGGC
GTTTACTCCAG -> TTTACTCCAGA
GTTTGGTCCGG -> TTTGGTCCGGT
GTTTGGTTGAA -> TTTGGTTGAAA
GTTTTACAAAG -> TTTTACAAAGT
GTTTTACCCAC -> TTTTACCCACT
GTTTTCGTATC -> TTTTCGTATCC
GTTTTCTATTA -> TTTTCTATTAG
GTTTTGCAGCA -> TTTTGCAGCAC
GTTTTGGAACG -> TTTTGGAACGA
GTTTTTCGTCG -> TTTTTCGTCGA
GTTTTTGCCTC -> TTTTTGCCTCT
GTTTTTTCCCA -> TTTTTTCCCAC
TAAACATCATG -> AAACATCATGT
TAAACGGTTCG -> AAACGGTTCGC
TAAAGCCTACC -> AAAGCCTACCC
TAAATATACCC -> AAATATACCCT
TAACACATCAT -> AACACATCATT
TAACATCTTGC -> AACATCTTGCC
TAACCAAGTCA -> AACCAAGTCAG
TAACCACTCGG -> AACCACTCGGA
TAACCTGGATA -> AACCTGGATAC
TAACCTGGCTT -> AACCTGGCTTG
TAACGACTATT -> AACGACTATTA
TAACGCCAAAG -> AACGCCAAAGC
TAACGTTTTTT -> AACGTTTTTTC
TAACTGCAAGT -> AACTGCAAGTG
TAAGAACGTTC -> AAGAACGTTCT
TAAGATACGAT -> AAGATACGATC
TAAGATTTGAT -> AAGATTTGATA
TAAGCCGCAAT -> AAGCCGCAATC
TAAGCGCATGC -> AAGCGCATGCG
TAAGCGGTCAA -> AAGCGGTCAAA
TAAGCTACACG -> AAGCTACACGG
TAAGGCGATTC -> AAGGCGATTCA
TAAGGCGTTTT -> AAGGCGTTTTC
TAAGTCCGTCG -> AAGTCCGTCGA
TAAGTGTTCCT -> AAGTGTTCCTG
TAAGTTCACAA -> AAGTTCACAAA
TAATCTCCCAT -> AATCTCCCATA
TAATGAAAATG -> AATGAAAATGT
TAATGCGTTGT -> AATGCGTTGTG
TAATGGCGTTT -> AATGGCGTTTA
TAATTATCACG -> AATTATCACGT
TAATTCACCAC -> AATTCACCACC
TACAAAGTGCC -> ACAAAGTGCCT
TACAAGGCCCG -> ACAAGGCCCGA
TACACGGGAGA -> ACACGGGAGAC
TACATATCGCG -> ACATATCGCGA
TACATCCCATA -> ACATCCCATAC
TACATCGCTGC -> ACATCGCTGCC
TACCACCGAGA -> ACCACCGAGAA
TACCAGGTAGC -> ACCAGGTAGCC
TACCCACGGCT -> ACCCACGGCTA
TACCCACTATT -> ACCCACTATTC
TACCCTGACTG -> ACCCTGACTGG
TACCGCTCTTC -> ACCGCTCTTCG
TACCGCTTAGC -> ACCGCTTAGCT
TACCGGATTAC -> ACCGGATTACT
TACCGGGGCGA -> ACCGGGGCGAG
TACCTAAGCTA -> ACCTAAGCTAC
TACCTATAGGT -> ACCTATAGGTA
TACGAAAAATA -> ACGAAAAATAA
TACGAAGGAGT -> ACGAAGGAGTC
TACGAGTCCCC -> ACGAGTCCCCA
TACGATCTGTG -> ACGATCTGTGT
TACGGACGTGC -> ACGGACGTGCT
TACGGTGTCTC -> ACGGTGTCTCG
TACGGTTATTG -> ACGGTTATTGC
TACTATATGCG -> ACTATATGCGC
TACTCATCGAT -> ACTCATCGATT
TACTCCAGAGA -> ACTCCAGAGAG
TACTCCATGAC -> ACTCCATGACA
TACTCCTTACG -> ACTCCTTACGG
TACTGCCGTAG -> ACTGCCGTAGG
TACTGGGTCTT -> ACTGGGTCTTC
TACTGTGGGAT -> ACTGTGGGATG
TACTTACATCG -> ACTTACATCGC
TAGAATGAGTT -> AGAATGAGTTT
TAGAGGAACCT -> AGAGGAACCTT
TAGATAATTAT -> AGATAATTATC
TAGCAAACTCC -> AGCAAACTCCA
TAGCACGTTTA -> AGCACGTTTAC
TAGCCAATTGC -> AGCCAATTGCT
TAGCCTCTCCT -> AGCCTCTCCTG
TAGCGCCACCT -> AGCGCCACCTT
TAGCTTCTTGG -> AGCTTCTTGGT
TAGGAACTGGT -> AGGAACTGGTA
TAGGACTGTTT -> AGGACTGTTTG
TAGGCAGATTT -> AGGCAGATTTA
TAGGCCAATCG -> AGGCCAATCGC
TAGGCTAGTTG -> AGGCTAGTTGA
TAGGCTCTAAC -> AGGCTCTAACA
TAGGTATTGAG -> AGGTATTGAGT
TAGGTGTCAGT -> AGGTGTCAGTA
TAGTAGGAACT -> AGTAGGAACTG
TAGTCAATCAA -> AGTCAATCAAT
TAGTCAGCTCT -> AGTCAGCTCTC
TAGTGATTAAG -> AGTGATTAAGG
TAGTGCTAGTC -> AGTGCTAGTCA
TAGTTCAAACT -> AGTTCAAACTG
TAGTTGAGGTA -> AGTTGAGGTAA
TATAAGGCGTT -> ATAAGGCGTTT
TATAATGCGTT -> ATAATGCGTTG
TATACCCTGAC -> ATACCCTGACT
TATAGAATGAG -> ATAGAATGAGT
TATAGGTATTG -> ATAGGTATTGA
TATAGTTCAAA -> ATAGTTCAAAC
TATATCCGGCC -> ATATCCGGCCG
TATATGCGCTC -> ATATGCGCTCC
TATATGGAGGG -> ATATGGAGGGT
TATCAATCCAC -> ATCAATCCACT
TATCACGTTCA -> ATCACGTTCAC
TATCAGAGGTT -> ATCAGAGGTTG
TATCAGGGAGG -> ATCAGGGAGGA
TATCCGGCCGC -> ATCCGGCCGCA
TATCCTAGCAC -> ATCCTAGCACG
TATCCTGTATA -> ATCCTGTATAG
TATCCTTTGTC -> ATCCTTTGTCT
TATCGCGAAGG -> ATCGCGAAGGC
TATCTACTCAT -> ATCTACTCATC
TATCTCAGTTC -> ATCTCAGTTCT
TATGACCGGGG -> ATGACCGGGGA
TATGCGCTCCC -> ATGCGCTCCCA
TATGGAGGGTG -> ATGGAGGGTGC
TATGGTACGAA -> ATGGTACGAAG
TATGTTTTGGA -> ATGTTTTGGAA
TATTAGGTGTC -> ATTAGGTGTCA
TATTAGTGATT -> ATTAGTGATTA
TATTCAGCGGC -> ATTCAGCGGCC
TATTGAGTCTG -> ATTGAGTCTGC
TATTGCCAATC -> ATTGCCAATCG
TATTTTCTCAC -> ATTTTCTCACG
TCAAACTGAGC -> CAAACTGAGCA
TCAAAGCTCGG -> CAAAGCTCGGG
TCAAATTTGCC -> CAAATTTGCCA
TCAACTGTTTA -> CAACTGTTTAC
TCAATACTCCT -> CAATACTCCTT
TCAATCAATAC -> CAATCAATACT
TCAATCCACTG -> CAATCCACTGT
TCAATCTACAA -> CAATCTACAAG
TCAATGCGAGT -> CAATGCGAGTC
TCACAAAAGGT -> CACAAAAGGTC
TCACACACAGG -> CACACACAGGC
TCACATGCTCC -> CACATGCTCCC
TCACCACCCTA -> CACCACCCTAG
TCACCAGAATC -> CACCAGAATCG
TCACGATAACG -> CACGATAACGC
TCACGTTCACA -> CACGTTCACAT
TCACGTTCTTC -> CACGTTCTTCA
TCAGAGGTTGG -> CAGAGGTTGGG
TCAGCGGCCCC -> CAGCGGCCCCA
TCAGCTCTCTA -> CAGCTCTCTAG
TCAGGACGTCG -> CAGGACGTCGC
TCAGGGAGGAA -> CAGGGAGGAAT
TCAGTAATGAA -> CAGTAATGAAA
TCAGTATCCTT -> CAGTATCCTTT
TCAGTTCTCTT -> CAGTTCTCTTA
TCAGTTGGTGC -> CAGTTGGTGCT
TCATAGGACTG -> CATAGGACTGT
TCATATCCTAG -> CATATCCTAGC
TCATCGATTGC -> CATCGATTGCC
TCATGTATAAG -> CATGTATAAGG
TCATTAACGTT -> CATTAACGTTT
TCATTTATCAG -> CATTTATCAGG
TCATTTCCTGA -> CATTTCCTGAA
TCATTTGACAC -> CATTTGACACG
TCCAAAATGCG -> CCAAAATGCGC
TCCAAACCTTC -> CCAAACCTTCA
TCCAAAGTATA -> CCAAAGTATAT
TCCACGGTAAC -> CCACGGTAACT
TCCACTGTCCG -> CCACTGTCCGC
TCCAGAGAGGG -> CCAGAGAGGGA
TCCATGACAGC -> CCATGACAGCG
TCCCACGCAAG -> CCCACGCAAGT
TCCCACTTCTT -> CCCACTTCTTT
TCCCAGTCAGG -> CCCAGTCAGGA
TCCCATACGAG -> CCCATACGAGT
TCCCATATAGT -> CCCATATAGTT
TCCCCAATAGT -> CCCCAATAGTG
TCCCCACGACC -> CCCCACGACCG
TCCCCCTAAGT -> CCCCCTAAGTC
TCCCGAGGCAC -> CCCGAGGCACA
TCCCTCGCCCG -> CCCTCGCCCGT
TCCGACGCCAC -> CCGACGCCACG
TCCGCTCCTAC -> CCGCTCCTACC
TCCGGCCGCAG -> CCGGCCGCAGA
TCCGGTTACCA -> CCGGTTACCAC
TCCGTCGAAAA -> CCGTCGAAAAG
TCCGTGTGCAG -> CCGTGTGCAGG
TCCTACCGCTC -> CCTACCGCTCT
TCCTAGCACGT -> CCTAGCACGTT
TCCTATGTTTT -> CCTATGTTTTG
TCCTCCAAACC -> CCTCCAAACCT
TCCTCCTATGT -> CCTCCTATGTT
TCCTCCTCCTA -> CCTCCTCCTAT
TCCTGAAATGC -> CCTGAAATGCC
TCCTGGCTGAT -> CCTGGCTGATG
TCCTGTACCAG -> CCTGTACCAGG
TCCTGTATAGA -> CCTGTATAGAA
TCCTGTTACCT -> CCTGTTACCTA
TCCTTACGGAC -> CCTTACGGACG
TCCTTTGTCTA -> CCTTTGTCTAA
TCGAAAAGACG -> CGAAAAGACGG
TCGAAAAGCGG -> CGAAAAGCGGT
TCGACTGATAT -> CGACTGATATT
TCGATCTAATG -> CGATCTAATGG
TCGATTGCCGT -> CGATTGCCGTG
TCGCATGATTA -> CGCATGATTAA
TCGCCAGCCAT -> CGCCAGCCATT
TCGCCAGGTTA -> CGCCAGGTTAT
TCGCCCGTGGA -> CGCCCGTGGAT
TCGCCGACGTT -> CGCCGACGTTT
TCGCGAAGGCA -> CGCGAAGGCAC
TCGCGACTATC -> CGCGACTATCA
TCGCTAAGCGC -> CGCTAAGCGCA
TCGCTAGCGCC -> CGCTAGCGCCA
TCGCTGCCCAC -> CGCTGCCCACC
TCGCTTTGGGT -> CGCTTTGGGTA
TCGGAACCCCC -> CGGAACCCCCT
TCGGACACCAA -> CGGACACCAAA
TCGGATATGGT -> CGGATATGGTA
TCGGCGACATG -> CGGCGACATGT
TCGGCGTCACG -> CGGCGTCACGA
TCGGGACGGAA -> CGGGACGGAAA
TCGGGTGAAGT -> CGGGTGAAGTT
TCGTAAGTTCA -> CGTAAGTTCAC
TCGTATAATGC -> CGTATAATGCG
TCGTATCCTGT -> CGTATCCTGTA
TCGTCGAAAAG -> CGTCGAAAAGC
TCGTGGCACCC -> CGTGGCACCCA
TCGTTTGGTCC -> CGTTTGGTCCG
TCTAACATCTT -> CTAACATCTTG
TCTAAGATACG -> CTAAGATACGA
TCTAATGGCGT -> CTAATGGCGTT
TCTACAAGGCC -> CTACAAGGCCC
TCTACTCATCG -> CTACTCATCGA
TCTAGAGGAAC -> CTAGAGGAACC
TCTAGATAATT -> CTAGATAATTA
TCTATTAGGTG -> CTATTAGGTGT
TCTCACGTTCT -> CTCACGTTCTT
TCTCAGTTCTC -> CTCAGTTCTCT
TCTCCCATATA -> CTCCCATATAG
TCTCCTCCTCC -> CTCCTCCTCCT
TCTCCTGTTAC -> CTCCTGTTACC
TCTCGGATATG -> CTCGGATATGG
TCTCGTATAAT -> CTCGTATAATG
TCTCTAGATAA -> CTCTAGATAAT
TCTCTTATCTA -> CTCTTATCTAC
TCTGCCCGGGG -> CTGCCCGGGGG
TCTGCGGAACT -> CTGCGGAACTG
TCTGCTGGTTA -> CTGCTGGTTAA
TCTGGGGCCGC -> CTGGGGCCGCG
TCTGTGTTGAC -> CTGTGTTGACC
TCTTAACCACT -> CTTAACCACTC
TCTTAAGTGTT -> CTTAAGTGTTC
TCTTAGGCTCT -> CTTAGGCTCTA
TCTTATCTACT -> CTTATCTACTC
TCTTCATTTCC -> CTTCATTTCCT
TCTTCCAAAGT -> CTTCCAAAGTA
TCTTCGTTTGG -> CTTCGTTTGGT
TCTTGAGGAAC -> CTTGAGGAACC
TCTTGCCGGTG -> CTTGCCGGTGG
TCTTGGTACTG -> CTTGGTACTGG
TCTTTTCCCAC -> CTTTTCCCACG
TGAAAATGTCC -> GAAAATGTCCT
TGAAAGTCATA -> GAAAGTCATAT
TGAAATGCCCC -> GAAATGCCCCC
TGAAGTTCACC -> GAAGTTCACCA
TGACACGCAAC -> GACACGCAACG
TGACAGCGCTG -> GACAGCGCTGG
TGACAGTCGTA -> GACAGTCGTAA
TGACCCGTGGT -> GACCCGTGGTC
TGACCGGGGAA -> GACCGGGGAAG
TGACGTCGCCG -> GACGTCGCCGA
TGACTGGGTGG -> GACTGGGTGGA
TGAGCAACGGG -> GAGCAACGGGT
TGAGGAACCAT -> GAGGAACCATA
TGAGGTAACAC -> GAGGTAACACA
TGAGGTCCACG -> GAGGTCCACGG
TGAGTCTGCGG -> GAGTCTGCGGA
TGAGTTTTACC -> GAGTTTTACCC
TGATAAATATA -> GATAAATATAC
TGATAGGCCAA -> GATAGGCCAAT
TGATATTTTCT -> GATATTTTCTC
TGATCTCCTCC -> GATCTCCTCCT
TGATGTGATCT -> GATGTGATCTC
TGATTAACCAA -> GATTAACCAAG
TGATTAAGGCG -> GATTAAGGCGA
TGATTCAATGC -> GATTCAATGCG
TGCAAGTGCGC -> GCAAGTGCGCG
TGCACACAACG -> GCACACAACGC
TGCAGCACGCA -> GCAGCACGCAT
TGCAGGGAAAC -> GCAGGGAAACC
TGCCAATCGAT -> GCCAATCGATC
TGCCAATTCCC -> GCCAATTCCCC
TGCCCACCAGC -> GCCCACCAGCC
TGCCCCCCTCG -> GCCCCCCTCGC
TGCCCCGCATG -> GCCCCGCATGT
TGCCCGGGGGC -> GCCCGGGGGCT
TGCCGCGCTCG -> GCCGCGCTCGC
TGCCGGTGGCT -> GCCGGTGGCTA
TGCCGTAGGCT -> GCCGTAGGCTA
TGCCGTGCACA -> GCCGTGCACAC
TGCCGTGTAAA -> GCCGTGTAAAC
TGCCTCTTAAC -> GCCTCTTAACC
TGCCTTGTCGT -> GCCTTGTCGTG
TGCGAGTCGAC -> GCGAGTCGACT
TGCGCATACGG -> GCGCATACGGT
TGCGCGAGGAT -> GCGCGAGGATG
TGCGCGCTAAC -> GCGCGCTAACG
TGCGCGTGATA -> GCGCGTGATAG
TGCGCTAAGCC -> GCGCTAAGCCG
TGCGCTAATCT -> GCGCTAATCTC
TGCGCTCCCAG -> GCGCTCCCAGT
TGCGGAACTGA -> GCGGAACTGAG
TGCGGTCGCTA -> GCGGTCGCTAA,GCGGTCGCTAG
TGCGTTGTGTT -> GCGTTGTGTTG
TGCTAGCAAAC -> GCTAGCAAACT
TGCTAGTCAAT -> GCTAGTCAATC
TGCTCCCCCTA -> GCTCCCCCTAA
TGCTCCGTGTG -> GCTCCGTGTGC
TGCTGGCAGCA -> GCTGGCAGCAG
TGCTGGTTAAC -> GCTGGTTAACC
TGGAACGAGGA -> GGAACGAGGAA
TGGACGCCTTC -> GGACGCCTTCT
TGGAGGGTGCG -> GGAGGGTGCGC
TGGATACTCCA -> GGATACTCCAT
TGGATGGCGAC -> GGATGGCGACT
TGGCACCCAGG -> GGCACCCAGGT
TGGCAGCAGCG -> GGCAGCAGCGG
TGGCGACTAAA -> GGCGACTAAAG
TGGCGTTTACC -> GGCGTTTACCG
TGGCTACTATA -> GGCTACTATAT
TGGCTGATGTG -> GGCTGATGTGA
TGGCTTGTCAT -> GGCTTGTCATT
TGGGAACTCCG -> GGGAACTCCGA
TGGGATGACGT -> GGGATGACGTC
TGGGGCCGCGC -> GGGGCCGCGCC
TGGGTAGTAGG -> GGGTAGTAGGA
TGGGTCTTCCA -> GGGTCTTCCAA
TGGGTGGACGC -> GGGTGGACGCC
TGGTACCTAAG -> GGTACCTAAGC
TGGTACGAAGG -> GGTACGAAGGA
TGGTACTGGGT -> GGTACTGGGTC
TGGTCAGTTGG -> GGTCAGTTGGT
TGGTCCGGTTA -> GGTCCGGTTAC
TGGTGCTGGCA -> GGTGCTGGCAG
TGGTTAACCTG -> GGTTAACCTGG
TGGTTGAAAGT -> GGTTGAAAGTC
TGGTTGATTCA -> GGTTGATTCAA
TGTAAACATCA -> GTAAACATCAT
TGTACCAGGTA -> GTACCAGGTAG
TGTACCGGATT -> GTACCGGATTA
TGTAGCCTCTC -> GTAGCCTCTCC
TGTATAAGGCG -> GTATAAGGCGT
TGTATAGAATG -> GTATAGAATGA
TGTCAGTATCC -> GTCAGTATCCT
TGTCATAGGAC -> GTCATAGGACT
TGTCATTAACG -> GTCATTAACGT
TGTCCGCTCCT -> GTCCGCTCCTA
TGTCCTCCAAA -> GTCCTCCAAAC
TGTCGTGGCAC -> GTCGTGGCACC
TGTCTAAGATA -> GTCTAAGATAC
TGTCTCGGATA -> GTCTCGGATAT
TGTGATCTCCT -> GTGATCTCCTC
TGTGCAGGGAA -> GTGCAGGGAAA
TGTGCGCTAAG -> GTGCGCTAAGC
TGTGGGATGAC -> GTGGGATGACG
TGTGTGCGCTA -> GTGTGCGCTAA
TGTGTTGACCC -> GTGTTGACCCG
TGTGTTGCGGT -> GTGTTGCGGTC
TGTTACCTATA -> GTTACCTATAG
TGTTCCTGTAC -> GTTCCTGTACC
TGTTGACCCGT -> GTTGACCCGTG
TGTTGCGGTCG -> GTTGCGGTCGC
TGTTTACCGCT -> GTTTACCGCTT
TGTTTGGTTGA -> GTTTGGTTGAA
TGTTTTACAAA -> GTTTTACAAAG
TGTTTTGGAAC -> GTTTTGGAACG
TTAACCAAGTC -> TAACCAAGTCA
TTAACCACTCG -> TAACCACTCGG
TTAACCTGGAT -> TAACCTGGATA
TTAACCTGGCT -> TAACCTGGCTT
TTAACGTTTTT -> TAACGTTTTTT
TTAAGAACGTT -> TAAGAACGTTC
TTAAGGCGATT -> TAAGGCGATTC
TTAAGTGTTCC -> TAAGTGTTCCT
TTAATTCACCA -> TAATTCACCAC
TTACAAAGTGC -> TACAAAGTGCC
TTACATCCCAT -> TACATCCCATA
TTACATCGCTG -> TACATCGCTGC
TTACCACCGAG -> TACCACCGAGA
TTACCCACTAT -> TACCCACTATT
TTACCGCTTAG -> TACCGCTTAGC
TTACCGGGGCG -> TACCGGGGCGA
TTACCTATAGG -> TACCTATAGGT
TTACGAAAAAT -> TACGAAAAATA
TTACGGACGTG -> TACGGACGTGC
TTACGGTTATT -> TACGGTTATTG
TTACTCCAGAG -> TACTCCAGAGA
TTACTGTGGGA -> TACTGTGGGAT
TTAGCTTCTTG -> TAGCTTCTTGG
TTAGGCTCTAA -> TAGGCTCTAAC
TTAGGTGTCAG -> TAGGTGTCAGT
TTAGTGATTAA -> TAGTGATTAAG
TTATCACGTTC -> TATCACGTTCA
TTATCAGAGGT -> TATCAGAGGTT
TTATCAGGGAG -> TATCAGGGAGG
TTATCTACTCA -> TATCTACTCAT
TTATCTCAGTT -> TATCTCAGTTC
TTATTGCCAAT -> TATTGCCAATC
TTCAAACTGAG -> TCAAACTGAGC
TTCAAATTTGC -> TCAAATTTGCC
TTCAATGCGAG -> TCAATGCGAGT
TTCACAAAAGG -> TCACAAAAGGT
TTCACATGCTC -> TCACATGCTCC
TTCACCACCCT -> TCACCACCCTA
TTCACCAGAAT -> TCACCAGAATC
TTCAGCGGCCC -> TCAGCGGCCCC
TTCATTTCCTG -> TCATTTCCTGA
TTCATTTGACA -> TCATTTGACAC
TTCCAAAGTAT -> TCCAAAGTATA
TTCCCACGCAA -> TCCCACGCAAG
TTCCCACTTCT -> TCCCACTTCTT
TTCCCCAATAG -> TCCCCAATAGT
TTCCTGAAATG -> TCCTGAAATGC
TTCCTGTACCA -> TCCTGTACCAG
TTCGCATGATT -> TCGCATGATTA
TTCGTATCCTG -> TCGTATCCTGT
TTCGTCGAAAA -> TCGTCGAAAAG
TTCGTTTGGTC -> TCGTTTGGTCC
TTCTATTAGGT -> TCTATTAGGTG
TTCTCACGTTC -> TCTCACGTTCT
TTCTCTTATCT -> TCTCTTATCTA
TTCTGCTGGTT -> TCTGCTGGTTA
TTCTTAAGTGT -> TCTTAAGTGTT
TTCTTAGGCTC -> TCTTAGGCTCT
TTCTTCATTTC -> TCTTCATTTCC
TTCTTGAGGAA -> TCTTGAGGAAC
TTCTTGGTACT -> TCTTGGTACTG
TTCTTTTCCCA -> TCTTTTCCCAC
TTGAAAGTCAT -> TGAAAGTCATA
TTGACACGCAA -> TGACACGCAAC
TTGACAGTCGT -> TGACAGTCGTA
TTGACCCGTGG -> TGACCCGTGGT
TTGAGGAACCA -> TGAGGAACCAT
TTGAGGTAACA -> TGAGGTAACAC
TTGAGTCTGCG -> TGAGTCTGCGG
TTGATAAATAT -> TGATAAATATA
TTGATTCAATG -> TGATTCAATGC
TTGCAGCACGC -> TGCAGCACGCA
TTGCCAATCGA -> TGCCAATCGAT
TTGCCAATTCC -> TGCCAATTCCC
TTGCCGGTGGC -> TGCCGGTGGCT
TTGCCGTGTAA -> TGCCGTGTAAA
TTGCCTCTTAA -> TGCCTCTTAAC
TTGCGCGAGGA -> TGCGCGAGGAT
TTGCGGTCGCT -> TGCGGTCGCTA
TTGCTCCGTGT -> TGCTCCGTGTG
TTGGAACGAGG -> TGGAACGAGGA
TTGGGAACTCC -> TGGGAACTCCG
TTGGGTAGTAG -> TGGGTAGTAGG
TTGGTACTGGG -> TGGTACTGGGT
TTGGTCCGGTT -> TGGTCCGGTTA
TTGGTGCTGGC -> TGGTGCTGGCA
TTGGTTGAAAG -> TGGTTGAAAGT
TTGTAGCCTCT -> TGTAGCCTCTC
TTGTCATTAAC -> TGTCATTAACG
TTGTCGTGGCA -> TGTCGTGGCAC
TTGTCTAAGAT -> TGTCTAAGATA
TTGTGTGCGCT -> TGTGTGCGCTA
TTGTGTTGCGG -> TGTGTTGCGGT
TTTAACCTGGC -> TTAACCTGGCT
TTTAAGAACGT -> TTAAGAACGTT
TTTACAAAGTG -> TTACAAAGTGC
TTTACCCACTA -> TTACCCACTAT
TTTACCGCTTA -> TTACCGCTTAG
TTTACCGGGGC -> TTACCGGGGCG
TTTACTCCAGA -> TTACTCCAGAG
TTTATCAGGGA -> TTATCAGGGAG
TTTCCCACGCA -> TTCCCACGCAA
TTTCCCACTTC -> TTCCCACTTCT
TTTCCTGAAAT -> TTCCTGAAATG
TTTCGTATCCT -> TTCGTATCCTG
TTTCGTCGAAA -> TTCGTCGAAAA
TTTCTATTAGG -> TTCTATTAGGT
TTTCTCACGTT -> TTCTCACGTTC
TTTGACACGCA -> TTGACACGCAA
TTTGATAAATA -> TTGATAAATAT
TTTGCAGCACG -> TTGCAGCACGC
TTTGCCAATTC -> TTGCCAATTCC
TTTGCCTCTTA -> TTGCCTCTTAA
TTTGGAACGAG -> TTGGAACGAGG
TTTGGGTAGTA -> TTGGGTAGTAG
TTTGGTCCGGT -> TTGGTCCGGTT
TTTGGTTGAAA -> TTGGTTGAAAG
TTTGTCTAAGA -> TTGTCTAAGAT
TTTGTGTGCGC -> TTGTGTGCGCT
TTTTACAAAGT -> TTTACAAAGTG
TTTTACCCACT -> TTTACCCACTA
TTTTCCCACGC -> TTTCCCACGCA
TTTTCCCACTT -> TTTCCCACTTC
TTTTCGTATCC -> TTTCGTATCCT
TTTTCGTCGAA -> TTTCGTCGAAA
TTTTCTATTAG -> TTTCTATTAGG
TTTTCTCACGT -> TTTCTCACGTT
TTTTGCAGCAC -> TTTGCAGCACG
TTTTGCCTCTT -> TTTGCCTCTTA
TTTTGGAACGA -> TTTGGAACGAG
TTTTGTGTGCG -> TTTGTGTGCGC
TTTTTCCCACT -> TTTTCCCACTT
TTTTTCGTCGA -> TTTTCGTCGAA
TTTTTGCCTCT -> TTTTGCCTCTT
TTTTTTCCCAC -> TTTTTCCCACT