AAAAAGTTCTGGAAGCCGG -> AAAAGTTCTGGAAGCCGGG
AAAACTGCACGTTTGCTGG -> AAACTGCACGTTTGCTGGG
AAAAGCACGAGTATGTGAT -> AAAGCACGAGTATGTGATC
AAAAGTTCTGGAAGCCGGG -> AAAGTTCTGGAAGCCGGGT
AAAATTGAAGCGCGAATCG -> AAATTGAAGCGCGAATCGT
AAACATCAGAACACCGTCC -> AACATCAGAACACCGTCCG
AAACGAATAGTTGGGCCGC -> AACGAATAGTTGGGCCGCG
AAACGGACGATTCAGCGTG -> AACGGACGATTCAGCGTGA
AAACTGCACGTTTGCTGGG -> AACTGCACGTTTGCTGGGC
AAAGCACGAGTATGTGATC -> AAGCACGAGTATGTGATCC
AAAGCCTACTCATGGCCAA -> AAGCCTACTCATGGCCAAC
AAAGCGTTGCACACCTACA -> AAGCGTTGCACACCTACAC
AAAGCTCTGGCCACTTAGC -> AAGCTCTGGCCACTTAGCG
AAAGGATTACGTCTTGTGA -> AAGGATTACGTCTTGTGAA
AAAGTGCCATACCCTTCTG -> AAGTGCCATACCCTTCTGC
AAAGTTCTGGAAGCCGGGT -> AAGTTCTGGAAGCCGGGTT
AAAGTTGGGGGGGTGGCGA -> AAGTTGGGGGGGTGGCGAG
AAATAGACTCCAGGAAAGC -> AATAGACTCCAGGAAAGCT
AAATCCACGATTAGTGGCA -> AATCCACGATTAGTGGCAC
AAATCCAGATATCACCAGT -> AATCCAGATATCACCAGTC
AAATCCCGTGCTTGACCAC -> AATCCCGTGCTTGACCACA
AAATTGAAGCGCGAATCGT -> AATTGAAGCGCGAATCGTC
AACAACCTCTTATTGACAG -> ACAACCTCTTATTGACAGG
AACAATGCCCGTCAACAAC -> ACAATGCCCGTCAACAACC
AACACCGTCCGCTCGAATC -> ACACCGTCCGCTCGAATCT
AACACCTTGGTTTAGACCG -> ACACCTTGGTTTAGACCGT
AACACGGTCAATAAGGTGT -> ACACGGTCAATAAGGTGTT
AACACGTTGAGAGGCTAGT -> ACACGTTGAGAGGCTAGTG
AACAGAGCTCAGGGTTCAT -> ACAGAGCTCAGGGTTCATT
AACAGCCGGGCCTTTACAT -> ACAGCCGGGCCTTTACATG
AACAGCTATGTCTCGTTGG -> ACAGCTATGTCTCGTTGGA
AACATAGTGCCATACCCTT -> ACATAGTGCCATACCCTTC
AACATCAGAACACCGTCCG -> ACATCAGAACACCGTCCGC
AACATCTTAACAGCCGGGC -> ACATCTTAACAGCCGGGCC
AACCAGCCTCAGGCGGAGA -> ACCAGCCTCAGGCGGAGAG
AACCATAATAGGAGCCACC -> ACCATAATAGGAGCCACCG
AACCGGTTAATCGTGCTGT -> ACCGGTTAATCGTGCTGTA
AACCTCGCCAGGCATAATA -> ACCTCGCCAGGCATAATAG
AACCTCTTATTGACAGGCT -> ACCTCTTATTGACAGGCTA
AACCTTCGAACGTGTAGAG -> ACCTTCGAACGTGTAGAGT
AACCTTGAACACGTTGAGA -> ACCTTGAACACGTTGAGAG
AACGAATAGTTGGGCCGCG -> ACGAATAGTTGGGCCGCGG
AACGATGGCCGCGATCCAA -> ACGATGGCCGCGATCCAAG
AACGCGCTGTTTAATGTCC -> ACGCGCTGTTTAATGTCCA
AACGGACGATTCAGCGTGA -> ACGGACGATTCAGCGTGAT
AACGGACTGGTGTGGCAGA -> ACGGACTGGTGTGGCAGAG
AACGGGAGTCGACTAAAAT -> ACGGGAGTCGACTAAAATT
AACGGTAATCAAGACACGA -> ACGGTAATCAAGACACGAG
AACGTGTAGAGTTTAGACG -> ACGTGTAGAGTTTAGACGA
AACTACAATTAAGCACCGA -> ACTACAATTAAGCACCGAC
AACTATCAGACATGATATG -> ACTATCAGACATGATATGT
AACTGACCATACGGCGTCG -> ACTGACCATACGGCGTCGA
AACTGCACGTTTGCTGGGC -> ACTGCACGTTTGCTGGGCC
AACTGGAAATAGACTCCAG -> ACTGGAAATAGACTCCAGG
AAGAAAAGCACGAGTATGT -> AGAAAAGCACGAGTATGTG
AAGAAAGTTGGGGGGGTGG -> AGAAAGTTGGGGGGGTGGC
AAGACACGAGCGTCCGGAA -> AGACACGAGCGTCCGGAAC
AAGATACAACTGACCATAC -> AGATACAACTGACCATACG
AAGATTTACTCCCCTTTGT -> AGATTTACTCCCCTTTGTA
AAGCACCGACGGAGCTTCA -> AGCACCGACGGAGCTTCAC
AAGCACGAGTATGTGATCC -> AGCACGAGTATGTGATCCC
AAGCAGCCACACAAGAAAG -> AGCAGCCACACAAGAAAGT
AAGCCGGGTTATTATCTAT -> AGCCGGGTTATTATCTATC
AAGCCTACTCATGGCCAAC -> AGCCTACTCATGGCCAACC
AAGCGCGAATCGTCCAACA -> AGCGCGAATCGTCCAACAT
AAGCGTATGCCAACGATGG -> AGCGTATGCCAACGATGGC
AAGCGTTGCACACCTACAC -> AGCGTTGCACACCTACACT
AAGCTCTGGCCACTTAGCG -> AGCTCTGGCCACTTAGCGA
AAGGAATTCCACTGGTCCT -> AGGAATTCCACTGGTCCTG
AAGGACCTCGCGCAGAATA -> AGGACCTCGCGCAGAATAG
AAGGATCTTGTGGCAGCCG -> AGGATCTTGTGGCAGCCGT
AAGGATTACGTCTTGTGAA -> AGGATTACGTCTTGTGAAA
AAGGTGGGCGGCCTAGAGA -> AGGTGGGCGGCCTAGAGAG
AAGGTGTTGTCAGTGTCGA -> AGGTGTTGTCAGTGTCGAT
AAGTCAGGGGCACGGAAAA -> AGTCAGGGGCACGGAAAAA
AAGTCGGGGGACGGCCTGG -> AGTCGGGGGACGGCCTGGT
AAGTGACCAATAATCCCAA -> AGTGACCAATAATCCCAAC
AAGTGCCATACCCTTCTGC -> AGTGCCATACCCTTCTGCC
AAGTGTTGTGGCGGCTTTA -> AGTGTTGTGGCGGCTTTAA
AAGTTCTGGAAGCCGGGTT -> AGTTCTGGAAGCCGGGTTA
AAGTTGATTGGGTGACTTT -> AGTTGATTGGGTGACTTTC
AAGTTGGGGGGGTGGCGAG -> AGTTGGGGGGGTGGCGAGT
AAGTTTCGTTCAAGTGACC -> AGTTTCGTTCAAGTGACCA
AATAAAGGATTACGTCTTG -> ATAAAGGATTACGTCTTGT
AATAAGGATCTTGTGGCAG -> ATAAGGATCTTGTGGCAGC
AATAAGGTGTTGTCAGTGT -> ATAAGGTGTTGTCAGTGTC
AATAATACGGGAACCTTGA -> ATAATACGGGAACCTTGAA
AATAATCCCAACCTTCGAA -> ATAATCCCAACCTTCGAAC
AATACCATAGAAGTTGATT -> ATACCATAGAAGTTGATTG
AATACCTAGGATACACCTA -> ATACCTAGGATACACCTAA
AATACGACTGCAAATCCCG -> ATACGACTGCAAATCCCGT
AATACGGGAACCTTGAACA -> ATACGGGAACCTTGAACAC
AATAGACTCCAGGAAAGCT -> ATAGACTCCAGGAAAGCTC
AATAGCCCGTGAGCTTTCT -> ATAGCCCGTGAGCTTTCTT
AATAGCGATAGACTTTTCG -> ATAGCGATAGACTTTTCGG
AATAGGACCCGTGGGAGAT -> ATAGGACCCGTGGGAGATC
AATAGGAGCCACCGTTTGC -> ATAGGAGCCACCGTTTGCT
AATAGTTGGGCCGCGGGCG -> ATAGTTGGGCCGCGGGCGT
AATAGTTTCGATGCTATCG -> ATAGTTTCGATGCTATCGG
AATCAAGACACGAGCGTCC -> ATCAAGACACGAGCGTCCG
AATCACAATACCTAGGATA -> ATCACAATACCTAGGATAC
AATCACAGCTACGATTGGC -> ATCACAGCTACGATTGGCT
AATCCACGATTAGTGGCAC -> ATCCACGATTAGTGGCACG
AATCCAGATATCACCAGTC -> ATCCAGATATCACCAGTCG
AATCCCAACCTTCGAACGT -> ATCCCAACCTTCGAACGTG
AATCCCGTGCTTGACCACA -> ATCCCGTGCTTGACCACAA
AATCCTGAAACGGACGATT -> ATCCTGAAACGGACGATTC
AATCGTCCAACATCTTAAC -> ATCGTCCAACATCTTAACA
AATCGTCTTTCATGTCGAT -> ATCGTCTTTCATGTCGATT
AATCGTGCTGTATGTACAA -> ATCGTGCTGTATGTACAAT
AATCGTTGCCTCCCTGCCT -> ATCGTTGCCTCCCTGCCTA
AATCTCAAAGCGTTGCACA -> ATCTCAAAGCGTTGCACAC
AATCTTGGCGGGTCCCGGA -> ATCTTGGCGGGTCCCGGAA
AATGCCCGTCAACAACCTC -> ATGCCCGTCAACAACCTCT
AATGCGAACTTCCAGTCAT -> ATGCGAACTTCCAGTCATG
AATGGCGAGGGTTTATCGA -> ATGGCGAGGGTTTATCGAT
AATGTAGCAAGATACAACT -> ATGTAGCAAGATACAACTG
AATGTCCACAGTTATCACT -> ATGTCCACAGTTATCACTT
AATTAAGCACCGACGGAGC -> ATTAAGCACCGACGGAGCT
AATTCCACTGGTCCTGCGG -> ATTCCACTGGTCCTGCGGT
AATTGAAGCGCGAATCGTC -> ATTGAAGCGCGAATCGTCC
AATTGCGATCGCGAGTGTA -> ATTGCGATCGCGAGTGTAT
ACAAACGAATAGTTGGGCC -> CAAACGAATAGTTGGGCCG
ACAACCTCGCCAGGCATAA -> CAACCTCGCCAGGCATAAT
ACAACCTCTTATTGACAGG -> CAACCTCTTATTGACAGGC
ACAACTGACCATACGGCGT -> CAACTGACCATACGGCGTC
ACAAGAAAGTTGGGGGGGT -> CAAGAAAGTTGGGGGGGTG
ACAAGCGTATGCCAACGAT -> CAAGCGTATGCCAACGATG
ACAATACCTAGGATACACC -> CAATACCTAGGATACACCT
ACAATCTTGGCGGGTCCCG -> CAATCTTGGCGGGTCCCGG
ACAATGCCCGTCAACAACC -> CAATGCCCGTCAACAACCT
ACAATTAAGCACCGACGGA -> CAATTAAGCACCGACGGAG
ACACAAGAAAGTTGGGGGG -> CACAAGAAAGTTGGGGGGG
ACACCGTCCGCTCGAATCT -> CACCGTCCGCTCGAATCTC
ACACCTAAGTTTCGTTCAA -> CACCTAAGTTTCGTTCAAG
ACACCTACACTCGCGATGC -> CACCTACACTCGCGATGCC
ACACCTTGGTTTAGACCGT -> CACCTTGGTTTAGACCGTA
ACACGAGCGTCCGGAACAA -> CACGAGCGTCCGGAACAAT
ACACGGTCAATAAGGTGTT -> CACGGTCAATAAGGTGTTG
ACACGTTGAGAGGCTAGTG -> CACGTTGAGAGGCTAGTGT
ACACTCGCGATGCCATAGC -> CACTCGCGATGCCATAGCG
ACAGAATCCTGAAACGGAC -> CAGAATCCTGAAACGGACG
ACAGACTCCGTAGAGACTC -> CAGACTCCGTAGAGACTCA
ACAGAGCTCAGGGTTCATT -> CAGAGCTCAGGGTTCATTC
ACAGAGGACTAGACAGTGA -> CAGAGGACTAGACAGTGAT
ACAGAGTCCGGCTGAATTG -> CAGAGTCCGGCTGAATTGC
ACAGCCGGGCCTTTACATG -> CAGCCGGGCCTTTACATGA
ACAGCTACGATTGGCTCTA -> CAGCTACGATTGGCTCTAG
ACAGCTATGTCTCGTTGGA -> CAGCTATGTCTCGTTGGAC
ACAGGCTAGTCAGCTGCTG -> CAGGCTAGTCAGCTGCTGC
ACAGTCGCTCGACGTGAAT -> CAGTCGCTCGACGTGAATA
ACAGTGATTAGATTACGTG -> CAGTGATTAGATTACGTGG
ACAGTGGGCAAGGTGGGCG -> CAGTGGGCAAGGTGGGCGG
ACAGTTATCACTTGTATTC -> CAGTTATCACTTGTATTCA
ACATAGTGCCATACCCTTC -> CATAGTGCCATACCCTTCT
ACATCAGAACACCGTCCGC -> CATCAGAACACCGTCCGCT
ACATCTCAGGTGCCATACC -> CATCTCAGGTGCCATACCC
ACATCTTAACAGCCGGGCC -> CATCTTAACAGCCGGGCCT
ACATGAGGGACCAACGGTA -> CATGAGGGACCAACGGTAA
ACATGATATGTACCAGGCA -> CATGATATGTACCAGGCAT
ACATGTCGGGAATACGACT -> CATGTCGGGAATACGACTG
ACCAAAGCCTACTCATGGC -> CCAAAGCCTACTCATGGCC
ACCAACGGTAATCAAGACA -> CCAACGGTAATCAAGACAC
ACCAATAATCCCAACCTTC -> CCAATAATCCCAACCTTCG
ACCACAAACGAATAGTTGG -> CCACAAACGAATAGTTGGG
ACCACAGACTCCGTAGAGA -> CCACAGACTCCGTAGAGAC
ACCAGCCTCAGGCGGAGAG -> CCAGCCTCAGGCGGAGAGT
ACCAGGCATTGGGGAATGG -> CCAGGCATTGGGGAATGGC
ACCAGTCGCCCGTAACGGA -> CCAGTCGCCCGTAACGGAC
ACCATAATAGGAGCCACCG -> CCATAATAGGAGCCACCGT
ACCATACGGCGTCGACGCG -> CCATACGGCGTCGACGCGT
ACCATAGAAGTTGATTGGG -> CCATAGAAGTTGATTGGGT
ACCCGTGGGAGATCGAGCT -> CCCGTGGGAGATCGAGCTA
ACCCTACAACCTCGCCAGG -> CCCTACAACCTCGCCAGGC
ACCCTGGGAATGTAGCAAG -> CCCTGGGAATGTAGCAAGA
ACCCTTCTGCCAATCGTCT -> CCCTTCTGCCAATCGTCTT
ACCCTTCTGCCAGCCTGAG -> CCCTTCTGCCAGCCTGAGG
ACCCTTCTGCCATAAGGAC -> CCCTTCTGCCATAAGGACC
ACCCTTCTGCCATATAAGT -> CCCTTCTGCCATATAAGTC
ACCGACGGAGCTTCACAGA -> CCGACGGAGCTTCACAGAG
ACCGGATTAATGCGAACTT -> CCGGATTAATGCGAACTTC
ACCGGCAAGTGTTGTGGCG -> CCGGCAAGTGTTGTGGCGG
ACCGGTTAATCGTGCTGTA -> CCGGTTAATCGTGCTGTAT
ACCGTACCGGCAAGTGTTG -> CCGTACCGGCAAGTGTTGT
ACCGTCCGCTCGAATCTCA -> CCGTCCGCTCGAATCTCAA
ACCGTTTGCTTTCCTTAAT -> CCGTTTGCTTTCCTTAATA
ACCTAACGCGCTGTTTAAT -> CCTAACGCGCTGTTTAATG
ACCTAAGTTTCGTTCAAGT -> CCTAAGTTTCGTTCAAGTG
ACCTACACTCGCGATGCCA -> CCTACACTCGCGATGCCAT
ACCTAGGATACACCTAAGT -> CCTAGGATACACCTAAGTT
ACCTCGCCAGGCATAATAG -> CCTCGCCAGGCATAATAGG
ACCTCGCGCAGAATAGCGA -> CCTCGCGCAGAATAGCGAT
ACCTCTTATTGACAGGCTA -> CCTCTTATTGACAGGCTAG
ACCTGTAGTTACCAAAGCC -> CCTGTAGTTACCAAAGCCT
ACCTTCGAACGTGTAGAGT -> CCTTCGAACGTGTAGAGTT
ACCTTGAACACGTTGAGAG -> CCTTGAACACGTTGAGAGG
ACCTTGGTTTAGACCGTAC -> CCTTGGTTTAGACCGTACC
ACGAACAGCTATGTCTCGT -> CGAACAGCTATGTCTCGTT
ACGAATAGTTGGGCCGCGG -> CGAATAGTTGGGCCGCGGG
ACGACTGCAAATCCCGTGC -> CGACTGCAAATCCCGTGCT
ACGAGCGTCCGGAACAATG -> CGAGCGTCCGGAACAATGC
ACGAGTATGTGATCCCTGG -> CGAGTATGTGATCCCTGGA
ACGATGGCCGCGATCCAAG -> CGATGGCCGCGATCCAAGA
ACGATTAGTGGCACGGAAT -> CGATTAGTGGCACGGAATC
ACGATTCAGCGTGATTATC -> CGATTCAGCGTGATTATCT
ACGATTGGCTCTAGCCGGG -> CGATTGGCTCTAGCCGGGC
ACGCGCTGTTTAATGTCCA -> CGCGCTGTTTAATGTCCAC
ACGCGTATATATGCCTAGC -> CGCGTATATATGCCTAGCA
ACGCGTGGGCTCAACTATC -> CGCGTGGGCTCAACTATCA
ACGGAAAAAGTTCTGGAAG -> CGGAAAAAGTTCTGGAAGC
ACGGAATCACAATACCTAG -> CGGAATCACAATACCTAGG
ACGGACGATTCAGCGTGAT -> CGGACGATTCAGCGTGATT
ACGGACTGGTGTGGCAGAG -> CGGACTGGTGTGGCAGAGC
ACGGAGCTTCACAGAGTCC -> CGGAGCTTCACAGAGTCCG
ACGGCCTGGTCACCCTACA -> CGGCCTGGTCACCCTACAA
ACGGCGTCGACGCGTATAT -> CGGCGTCGACGCGTATATA
ACGGGAACCTTGAACACGT -> CGGGAACCTTGAACACGTT
ACGGGAGTCGACTAAAATT -> CGGGAGTCGACTAAAATTG
ACGGTAATCAAGACACGAG -> CGGTAATCAAGACACGAGC
ACGGTCAATAAGGTGTTGT -> CGGTCAATAAGGTGTTGTC
ACGTATCCGTATGCCCAAT -> CGTATCCGTATGCCCAATA
ACGTCGTCGGATTAAATCC -> CGTCGTCGGATTAAATCCA
ACGTCTTGTGAAACATCAG -> CGTCTTGTGAAACATCAGA
ACGTGAATAAGGATCTTGT -> CGTGAATAAGGATCTTGTG
ACGTGGGAGCAATAGTTTC -> CGTGGGAGCAATAGTTTCG
ACGTGTAGAGTTTAGACGA -> CGTGTAGAGTTTAGACGAA
ACGTTGAGAGGCTAGTGTA -> CGTTGAGAGGCTAGTGTAT
ACGTTTGCTGGGCCGGCTC -> CGTTTGCTGGGCCGGCTCC
ACTAAAATTGAAGCGCGAA -> CTAAAATTGAAGCGCGAAT
ACTACAATTAAGCACCGAC -> CTACAATTAAGCACCGACG
ACTACAGAATCCTGAAACG -> CTACAGAATCCTGAAACGG
ACTAGACAGTGATTAGATT -> CTAGACAGTGATTAGATTA
ACTATCAGACATGATATGT -> CTATCAGACATGATATGTA
ACTATCGACCGGATTAATG -> CTATCGACCGGATTAATGC
ACTATCGTCCTGTCGGCCA -> CTATCGTCCTGTCGGCCAG
ACTCACGTATCCGTATGCC -> CTCACGTATCCGTATGCCC
ACTCATGGATGACCTAACG -> CTCATGGATGACCTAACGC
ACTCATGGCCAACCATAAT -> CTCATGGCCAACCATAATA
ACTCCAGGAAAGCTCTGGC -> CTCCAGGAAAGCTCTGGCC
ACTCCCCTTTGTAAGTCGG -> CTCCCCTTTGTAAGTCGGG
ACTCCGTAGAGACTCATGG -> CTCCGTAGAGACTCATGGA
ACTCGCGATGCCATAGCGT -> CTCGCGATGCCATAGCGTA
ACTCTCTGGTAATCACAGC -> CTCTCTGGTAATCACAGCT
ACTGACCATACGGCGTCGA -> CTGACCATACGGCGTCGAC
ACTGCAAATCCCGTGCTTG -> CTGCAAATCCCGTGCTTGA
ACTGCACGTTTGCTGGGCC -> CTGCACGTTTGCTGGGCCG
ACTGGAAATAGACTCCAGG -> CTGGAAATAGACTCCAGGA
ACTGGATGTGTGATCAGTT -> CTGGATGTGTGATCAGTTA
ACTGGTCCTGCGGTTGCCT -> CTGGTCCTGCGGTTGCCTG
ACTGGTGTGGCAGAGCCTC -> CTGGTGTGGCAGAGCCTCT
ACTGTAGCCTCGGGACATG -> CTGTAGCCTCGGGACATGT
ACTTAGCGAACGGGAGTCG -> CTTAGCGAACGGGAGTCGA
ACTTCAAATCCAGATATCA -> CTTCAAATCCAGATATCAC
ACTTCATAGACCACAGACT -> CTTCATAGACCACAGACTC
ACTTGTATTCAGCCACAGT -> CTTGTATTCAGCCACAGTG
ACTTTCGGTTACTGGATGT -> CTTTCGGTTACTGGATGTG
ACTTTCTAGGGGTCCAATA -> CTTTCTAGGGGTCCAATAG
ACTTTTCGGGAATCGTTGC -> CTTTTCGGGAATCGTTGCC
AGAAAAGCACGAGTATGTG -> GAAAAGCACGAGTATGTGA
AGAAAGTTGGGGGGGTGGC -> GAAAGTTGGGGGGGTGGCG
AGAACACCGTCCGCTCGAA -> GAACACCGTCCGCTCGAAT
AGAACTGGAAATAGACTCC -> GAACTGGAAATAGACTCCA
AGAAGTTGATTGGGTGACT -> GAAGTTGATTGGGTGACTT
AGAATAATACGGGAACCTT -> GAATAATACGGGAACCTTG
AGAATAGCGATAGACTTTT -> GAATAGCGATAGACTTTTC
AGAATCCTGAAACGGACGA -> GAATCCTGAAACGGACGAT
AGACACGAGCGTCCGGAAC -> GACACGAGCGTCCGGAACA
AGACAGTCGCTCGACGTGA -> GACAGTCGCTCGACGTGAA
AGACAGTGATTAGATTACG -> GACAGTGATTAGATTACGT
AGACATGATATGTACCAGG -> GACATGATATGTACCAGGC
AGACCACAGACTCCGTAGA -> GACCACAGACTCCGTAGAG
AGACCGTACCGGCAAGTGT -> GACCGTACCGGCAAGTGTT
AGACGAACAGCTATGTCTC -> GACGAACAGCTATGTCTCG
AGACTCATGGATGACCTAA -> GACTCATGGATGACCTAAC
AGACTCCAGGAAAGCTCTG -> GACTCCAGGAAAGCTCTGG
AGACTCCGTAGAGACTCAT -> GACTCCGTAGAGACTCATG
AGACTTTTCGGGAATCGTT -> GACTTTTCGGGAATCGTTG
AGAGACTCATGGATGACCT -> GAGACTCATGGATGACCTA
AGAGAGTGTTCCACAAGCG -> GAGAGTGTTCCACAAGCGT
AGAGCCTCTCGACTTTCGG -> GAGCCTCTCGACTTTCGGT
AGAGCTCAGGGTTCATTCC -> GAGCTCAGGGTTCATTCCT
AGAGGACTAGACAGTGATT -> GAGGACTAGACAGTGATTA
AGAGGCTAGTGTATTTCAT -> GAGGCTAGTGTATTTCATG
AGAGTCCGGCTGAATTGCG -> GAGTCCGGCTGAATTGCGA
AGAGTGTTCCACAAGCGTA -> GAGTGTTCCACAAGCGTAT
AGAGTTTAGACGAACAGCT -> GAGTTTAGACGAACAGCTA
AGAGTTTGAGTCCATCCCA -> GAGTTTGAGTCCATCCCAG
AGATACAACTGACCATACG -> GATACAACTGACCATACGG
AGATATCACCAGTCGCCCG -> GATATCACCAGTCGCCCGT
AGATCGAGCTACTTCATAG -> GATCGAGCTACTTCATAGA
AGATTACGTGGGAGCAATA -> GATTACGTGGGAGCAATAG
AGATTTACTCCCCTTTGTA -> GATTTACTCCCCTTTGTAA
AGCAAGATACAACTGACCA -> GCAAGATACAACTGACCAT
AGCAATAGTTTCGATGCTA -> GCAATAGTTTCGATGCTAT
AGCACCGACGGAGCTTCAC -> GCACCGACGGAGCTTCACA
AGCACGAGTATGTGATCCC -> GCACGAGTATGTGATCCCT
AGCAGCCACACAAGAAAGT -> GCAGCCACACAAGAAAGTT
AGCATCACTATCGACCGGA -> GCATCACTATCGACCGGAT
AGCCACACAAGAAAGTTGG -> GCCACACAAGAAAGTTGGG
AGCCACAGTGGGCAAGGTG -> GCCACAGTGGGCAAGGTGG
AGCCACCGTTTGCTTTCCT -> GCCACCGTTTGCTTTCCTT
AGCCCGTGAGCTTTCTTTC -> GCCCGTGAGCTTTCTTTCT
AGCCGGGCAGAACTGGAAA -> GCCGGGCAGAACTGGAAAT
AGCCGGGCCTTTACATGAG -> GCCGGGCCTTTACATGAGG
AGCCGGGTTATTATCTATC -> GCCGGGTTATTATCTATCT
AGCCGTCTGGATGTGTGAT -> GCCGTCTGGATGTGTGATC
AGCCTACTCATGGCCAACC -> GCCTACTCATGGCCAACCA
AGCCTCAGGCGGAGAGTTT -> GCCTCAGGCGGAGAGTTTG
AGCCTCGGGACATGTCGGG -> GCCTCGGGACATGTCGGGA
AGCCTCTCGACTTTCGGTT -> GCCTCTCGACTTTCGGTTA
AGCCTGAGGGTTTTTTTCC -> GCCTGAGGGTTTTTTTCCC
AGCGAACGGGAGTCGACTA -> GCGAACGGGAGTCGACTAA
AGCGATAGACTTTTCGGGA -> GCGATAGACTTTTCGGGAA
AGCGCGAATCGTCCAACAT -> GCGCGAATCGTCCAACATC
AGCGCGTCTTATACGTCGT -> GCGCGTCTTATACGTCGTC
AGCGTACCCTGGGAATGTA -> GCGTACCCTGGGAATGTAG
AGCGTATGCCAACGATGGC -> GCGTATGCCAACGATGGCC
AGCGTCCGGAACAATGCCC -> GCGTCCGGAACAATGCCCG
AGCGTGATTATCTTTGTGC -> GCGTGATTATCTTTGTGCG
AGCGTTGCACACCTACACT -> GCGTTGCACACCTACACTC
AGCTACGATTGGCTCTAGC -> GCTACGATTGGCTCTAGCC
AGCTACTTCATAGACCACA -> GCTACTTCATAGACCACAG
AGCTATGTCTCGTTGGACG -> GCTATGTCTCGTTGGACGC
AGCTCAGGGTTCATTCCTT -> GCTCAGGGTTCATTCCTTG
AGCTCTGGCCACTTAGCGA -> GCTCTGGCCACTTAGCGAA
AGCTGCTGCTGGGCCCGCA -> GCTGCTGCTGGGCCCGCAG
AGCTTCACAGAGTCCGGCT -> GCTTCACAGAGTCCGGCTG
AGCTTTCTTTCTAGGCGCT -> GCTTTCTTTCTAGGCGCTG
AGGAAAGCTCTGGCCACTT -> GGAAAGCTCTGGCCACTTA
AGGAATTCCACTGGTCCTG -> GGAATTCCACTGGTCCTGC
AGGACCCGTGGGAGATCGA -> GGACCCGTGGGAGATCGAG
AGGACCTCGCGCAGAATAG -> GGACCTCGCGCAGAATAGC
AGGACTAGACAGTGATTAG -> GGACTAGACAGTGATTAGA
AGGAGCCACCGTTTGCTTT -> GGAGCCACCGTTTGCTTTC
AGGAGTTATACTCTCTGGT -> GGAGTTATACTCTCTGGTA
AGGATACACCTAAGTTTCG -> GGATACACCTAAGTTTCGT
AGGATCTTGTGGCAGCCGT -> GGATCTTGTGGCAGCCGTC
AGGATTACGTCTTGTGAAA -> GGATTACGTCTTGTGAAAC
AGGCAAAGTGCCATACCCT -> GGCAAAGTGCCATACCCTT
AGGCATAATAGGACCCGTG -> GGCATAATAGGACCCGTGG
AGGCATTGGGGAATGGCGA -> GGCATTGGGGAATGGCGAG
AGGCGCTGGATGTGTGATC -> GGCGCTGGATGTGTGATCA
AGGCGGAGAGTTTGAGTCC -> GGCGGAGAGTTTGAGTCCA
AGGCTAGTCAGCTGCTGCT -> GGCTAGTCAGCTGCTGCTG
AGGCTAGTGTATTTCATGT -> GGCTAGTGTATTTCATGTG
AGGGACCAACGGTAATCAA -> GGGACCAACGGTAATCAAG
AGGGGCACGGAAAAAGTTC -> GGGGCACGGAAAAAGTTCT
AGGGGGCACTCACGTATCC -> GGGGGCACTCACGTATCCG
AGGGGTCCAATAGCCCGTG -> GGGGTCCAATAGCCCGTGA
AGGGTTCATTCCTTGTACC -> GGGTTCATTCCTTGTACCT
AGGGTTTATCGATAGGAGT -> GGGTTTATCGATAGGAGTT
AGGGTTTTTTTCCCCTTTG -> GGGTTTTTTTCCCCTTTGA
AGGTCAGTCCCCATGCTGT -> GGTCAGTCCCCATGCTGTG
AGGTGCCATACCCTTCTGC -> GGTGCCATACCCTTCTGCC
AGGTGGGCGGCCTAGAGAG -> GGTGGGCGGCCTAGAGAGT
AGGTGTTGTCAGTGTCGAT -> GGTGTTGTCAGTGTCGATG
AGTAAGGAATTCCACTGGT -> GTAAGGAATTCCACTGGTC
AGTATGTGATCCCTGGATG -> GTATGTGATCCCTGGATGT
AGTCAGCTGCTGCTGGGCC -> GTCAGCTGCTGCTGGGCCC
AGTCAGGGGCACGGAAAAA -> GTCAGGGGCACGGAAAAAG
AGTCCATCCCAGTTGAGGT -> GTCCATCCCAGTTGAGGTC
AGTCCCCATGCTGTGTTGG -> GTCCCCATGCTGTGTTGGG
AGTCCGGCTGAATTGCGAT -> GTCCGGCTGAATTGCGATC
AGTCCTACAGAGGACTAGA -> GTCCTACAGAGGACTAGAC
AGTCGACTAAAATTGAAGC -> GTCGACTAAAATTGAAGCG
AGTCGCCCGTAACGGACTG -> GTCGCCCGTAACGGACTGG
AGTCGCTCGACGTGAATAA -> GTCGCTCGACGTGAATAAG
AGTCGGGGGACGGCCTGGT -> GTCGGGGGACGGCCTGGTC
AGTGACCAATAATCCCAAC -> GTGACCAATAATCCCAACC
AGTGATTAGATTACGTGGG -> GTGATTAGATTACGTGGGA
AGTGCCATACCCTTCTGCC -> GTGCCATACCCTTCTGCCA,GTGCCATACCCTTCTGCCA
AGTGGCACGGAATCACAAT -> GTGGCACGGAATCACAATA
AGTGGGCAAGGTGGGCGGC -> GTGGGCAAGGTGGGCGGCC
AGTGTATCGGGATGTGCAA -> GTGTATCGGGATGTGCAAA
AGTGTATTTCATGTGGTGC -> GTGTATTTCATGTGGTGCG
AGTGTCGATGGTCTTGTTA -> GTGTCGATGGTCTTGTTAG
AGTGTTCCACAAGCGTATG -> GTGTTCCACAAGCGTATGC
AGTGTTGTGGCGGCTTTAA -> GTGTTGTGGCGGCTTTAAC
AGTTACCAAAGCCTACTCA -> GTTACCAAAGCCTACTCAT
AGTTAGGCAAAGTGCCATA -> GTTAGGCAAAGTGCCATAC
AGTTAGTTAGGCAAAGTGC -> GTTAGTTAGGCAAAGTGCC
AGTTATACTCTCTGGTAAT -> GTTATACTCTCTGGTAATC
AGTTATCACTTGTATTCAG -> GTTATCACTTGTATTCAGC
AGTTCGTTATCTTCGGTGC -> GTTCGTTATCTTCGGTGCC
AGTTCTGGAAGCCGGGTTA -> GTTCTGGAAGCCGGGTTAT
AGTTGAGGTCAGTCCCCAT -> GTTGAGGTCAGTCCCCATG
AGTTGATTGGGTGACTTTC -> GTTGATTGGGTGACTTTCT
AGTTGCACATCTCAGGTGC -> GTTGCACATCTCAGGTGCC
AGTTGGAAGATTTACTCCC -> GTTGGAAGATTTACTCCCC
AGTTGGGCCGCGGGCGTCC -> GTTGGGCCGCGGGCGTCCA
AGTTGGGGGGGTGGCGAGT -> GTTGGGGGGGTGGCGAGTA
AGTTTAGACGAACAGCTAT -> GTTTAGACGAACAGCTATG
AGTTTCGATGCTATCGGTC -> GTTTCGATGCTATCGGTCA
AGTTTCGTTCAAGTGACCA -> GTTTCGTTCAAGTGACCAA
AGTTTGAGTCCATCCCAGT -> GTTTGAGTCCATCCCAGTT
AGTTTGTGGAACATAGTGC -> GTTTGTGGAACATAGTGCC
ATAAAGGATTACGTCTTGT -> TAAAGGATTACGTCTTGTG
ATAAGGACCTCGCGCAGAA -> TAAGGACCTCGCGCAGAAT
ATAAGGATCTTGTGGCAGC -> TAAGGATCTTGTGGCAGCC
ATAAGGTGTTGTCAGTGTC -> TAAGGTGTTGTCAGTGTCG
ATAAGTCAGGGGCACGGAA -> TAAGTCAGGGGCACGGAAA
ATAATACGGGAACCTTGAA -> TAATACGGGAACCTTGAAC
ATAATAGGACCCGTGGGAG -> TAATAGGACCCGTGGGAGA
ATAATAGGAGCCACCGTTT -> TAATAGGAGCCACCGTTTG
ATAATCCCAACCTTCGAAC -> TAATCCCAACCTTCGAACG
ATACAACTGACCATACGGC -> TACAACTGACCATACGGCG
ATACACCTAAGTTTCGTTC -> TACACCTAAGTTTCGTTCA
ATACCATAGAAGTTGATTG -> TACCATAGAAGTTGATTGG
ATACCCTTCTGCCAATCGT -> TACCCTTCTGCCAATCGTC
ATACCCTTCTGCCAGCCTG -> TACCCTTCTGCCAGCCTGA
ATACCCTTCTGCCATAAGG -> TACCCTTCTGCCATAAGGA
ATACCCTTCTGCCATATAA -> TACCCTTCTGCCATATAAG
ATACCTAGGATACACCTAA -> TACCTAGGATACACCTAAG
ATACGACTGCAAATCCCGT -> TACGACTGCAAATCCCGTG
ATACGGCGTCGACGCGTAT -> TACGGCGTCGACGCGTATA
ATACGGGAACCTTGAACAC -> TACGGGAACCTTGAACACG
ATACGTCGTCGGATTAAAT -> TACGTCGTCGGATTAAATC
ATACTCTCTGGTAATCACA -> TACTCTCTGGTAATCACAG
ATAGAAGTTGATTGGGTGA -> TAGAAGTTGATTGGGTGAC
ATAGACCACAGACTCCGTA -> TAGACCACAGACTCCGTAG
ATAGACTCCAGGAAAGCTC -> TAGACTCCAGGAAAGCTCT
ATAGACTTTTCGGGAATCG -> TAGACTTTTCGGGAATCGT
ATAGCCCGTGAGCTTTCTT -> TAGCCCGTGAGCTTTCTTT
ATAGCGATAGACTTTTCGG -> TAGCGATAGACTTTTCGGG
ATAGCGTACCCTGGGAATG -> TAGCGTACCCTGGGAATGT
ATAGGACCCGTGGGAGATC -> TAGGACCCGTGGGAGATCG
ATAGGAGCCACCGTTTGCT -> TAGGAGCCACCGTTTGCTT
ATAGGAGTTATACTCTCTG -> TAGGAGTTATACTCTCTGG
ATAGTGCCATACCCTTCTG -> TAGTGCCATACCCTTCTGC
ATAGTTGGGCCGCGGGCGT -> TAGTTGGGCCGCGGGCGTC
ATAGTTTCGATGCTATCGG -> TAGTTTCGATGCTATCGGT
ATATAAGTCAGGGGCACGG -> TATAAGTCAGGGGCACGGA
ATATATGCCTAGCATCACT -> TATATGCCTAGCATCACTA
ATATCACCAGTCGCCCGTA -> TATCACCAGTCGCCCGTAA
ATATGCCTAGCATCACTAT -> TATGCCTAGCATCACTATC
ATATGTACCAGGCATTGGG -> TATGTACCAGGCATTGGGG
ATCAAGACACGAGCGTCCG -> TCAAGACACGAGCGTCCGG
ATCACAATACCTAGGATAC -> TCACAATACCTAGGATACA
ATCACAGCTACGATTGGCT -> TCACAGCTACGATTGGCTC
ATCACCAGTCGCCCGTAAC -> TCACCAGTCGCCCGTAACG
ATCACTATCGACCGGATTA -> TCACTATCGACCGGATTAA
ATCACTTGTATTCAGCCAC -> TCACTTGTATTCAGCCACA
ATCAGAACACCGTCCGCTC -> TCAGAACACCGTCCGCTCG
ATCAGACATGATATGTACC -> TCAGACATGATATGTACCA
ATCAGTTAGTTAGGCAAAG -> TCAGTTAGTTAGGCAAAGT
ATCAGTTCGTTATCTTCGG -> TCAGTTCGTTATCTTCGGT
ATCAGTTGCACATCTCAGG -> TCAGTTGCACATCTCAGGT
ATCAGTTTGTGGAACATAG -> TCAGTTTGTGGAACATAGT
ATCCAAGAAAAGCACGAGT -> TCCAAGAAAAGCACGAGTA
ATCCACGATTAGTGGCACG -> TCCACGATTAGTGGCACGG
ATCCAGATATCACCAGTCG -> TCCAGATATCACCAGTCGC
ATCCAGTTGGAAGATTTAC -> TCCAGTTGGAAGATTTACT
ATCCCAACCTTCGAACGTG -> TCCCAACCTTCGAACGTGT
ATCCCAGTTGAGGTCAGTC -> TCCCAGTTGAGGTCAGTCC
ATCCCGTGCTTGACCACAA -> TCCCGTGCTTGACCACAAA
ATCCCTGGATGTGTGATCA -> TCCCTGGATGTGTGATCAG
ATCCGTATGCCCAATAAAG -> TCCGTATGCCCAATAAAGG
ATCCTGAAACGGACGATTC -> TCCTGAAACGGACGATTCA
ATCGACCGGATTAATGCGA -> TCGACCGGATTAATGCGAA
ATCGAGCTACTTCATAGAC -> TCGAGCTACTTCATAGACC
ATCGATAGGAGTTATACTC -> TCGATAGGAGTTATACTCT
ATCGCGAGTGTATCGGGAT -> TCGCGAGTGTATCGGGATG
ATCGGGATGTGCAAAACTG -> TCGGGATGTGCAAAACTGC
ATCGGTCATCCAGTTGGAA -> TCGGTCATCCAGTTGGAAG
ATCGTCCAACATCTTAACA -> TCGTCCAACATCTTAACAG
ATCGTCCTGTCGGCCAGAC -> TCGTCCTGTCGGCCAGACA
ATCGTCTTTCATGTCGATT -> TCGTCTTTCATGTCGATTA
ATCGTGCTGTATGTACAAT -> TCGTGCTGTATGTACAATC
ATCGTTGCCTCCCTGCCTA -> TCGTTGCCTCCCTGCCTAC
ATCTATCTCGAGGGGGCAC -> TCTATCTCGAGGGGGCACT
ATCTCAAAGCGTTGCACAC -> TCTCAAAGCGTTGCACACC
ATCTCAGGTGCCATACCCT -> TCTCAGGTGCCATACCCTT
ATCTCGAGGGGGCACTCAC -> TCTCGAGGGGGCACTCACG
ATCTTAACAGCCGGGCCTT -> TCTTAACAGCCGGGCCTTT
ATCTTCGGTGCCATACCCT -> TCTTCGGTGCCATACCCTT
ATCTTGGCGGGTCCCGGAA -> TCTTGGCGGGTCCCGGAAC
ATCTTGTGGCAGCCGTCTG -> TCTTGTGGCAGCCGTCTGG
ATCTTTGTGCGTGTTTTCG -> TCTTTGTGCGTGTTTTCGT
ATGACCTAACGCGCTGTTT -> TGACCTAACGCGCTGTTTA
ATGACTTCAAATCCAGATA -> TGACTTCAAATCCAGATAT
ATGAGGGACCAACGGTAAT -> TGAGGGACCAACGGTAATC
ATGATATGTACCAGGCATT -> TGATATGTACCAGGCATTG
ATGCCAACGATGGCCGCGA -> TGCCAACGATGGCCGCGAT
ATGCCATAGCGTACCCTGG -> TGCCATAGCGTACCCTGGG
ATGCCCAATAAAGGATTAC -> TGCCCAATAAAGGATTACG
ATGCCCGTCAACAACCTCT -> TGCCCGTCAACAACCTCTT
ATGCCTAGCATCACTATCG -> TGCCTAGCATCACTATCGA
ATGCGAACTTCCAGTCATG -> TGCGAACTTCCAGTCATGC
ATGCTATCGGTCATCCAGT -> TGCTATCGGTCATCCAGTT
ATGCTGTGTTGGGTAACAG -> TGCTGTGTTGGGTAACAGA
ATGGATGACCTAACGCGCT -> TGGATGACCTAACGCGCTG
ATGGCCAACCATAATAGGA -> TGGCCAACCATAATAGGAG
ATGGCCGCGATCCAAGAAA -> TGGCCGCGATCCAAGAAAA
ATGGCGAGGGTTTATCGAT -> TGGCGAGGGTTTATCGATA
ATGGTCTTGTTAGAATAAT -> TGGTCTTGTTAGAATAATA
ATGTACAATCTTGGCGGGT -> TGTACAATCTTGGCGGGTC
ATGTACCAGGCATTGGGGA -> TGTACCAGGCATTGGGGAA
ATGTAGCAAGATACAACTG -> TGTAGCAAGATACAACTGA
ATGTCCACAGTTATCACTT -> TGTCCACAGTTATCACTTG
ATGTCGATTAAGCAGCCAC -> TGTCGATTAAGCAGCCACA
ATGTCGGGAATACGACTGC -> TGTCGGGAATACGACTGCA
ATGTCTCGTTGGACGCGTG -> TGTCTCGTTGGACGCGTGG
ATGTGATCCCTGGATGTGT -> TGTGATCCCTGGATGTGTG
ATGTGCAAAACTGCACGTT -> TGTGCAAAACTGCACGTTT
ATGTGGTGCGAACCGGTTA -> TGTGGTGCGAACCGGTTAA
ATGTGTGATCAGTTAGTTA -> TGTGTGATCAGTTAGTTAG
ATGTGTGATCAGTTCGTTA -> TGTGTGATCAGTTCGTTAT
ATGTGTGATCAGTTGCACA -> TGTGTGATCAGTTGCACAT
ATGTGTGATCAGTTTGTGG -> TGTGTGATCAGTTTGTGGA
ATTAAATCCACGATTAGTG -> TTAAATCCACGATTAGTGG
ATTAAGCACCGACGGAGCT -> TTAAGCACCGACGGAGCTT
ATTAAGCAGCCACACAAGA -> TTAAGCAGCCACACAAGAA
ATTAATGCGAACTTCCAGT -> TTAATGCGAACTTCCAGTC
ATTACGTCTTGTGAAACAT -> TTACGTCTTGTGAAACATC
ATTACGTGGGAGCAATAGT -> TTACGTGGGAGCAATAGTT
ATTAGATTACGTGGGAGCA -> TTAGATTACGTGGGAGCAA
ATTAGTGGCACGGAATCAC -> TTAGTGGCACGGAATCACA
ATTATCTATCTCGAGGGGG -> TTATCTATCTCGAGGGGGC
ATTATCTTTGTGCGTGTTT -> TTATCTTTGTGCGTGTTTT
ATTCAGCCACAGTGGGCAA -> TTCAGCCACAGTGGGCAAG
ATTCAGCGTGATTATCTTT -> TTCAGCGTGATTATCTTTG
ATTCCACTGGTCCTGCGGT -> TTCCACTGGTCCTGCGGTT
ATTCCTTGTACCTGTAGTT -> TTCCTTGTACCTGTAGTTA
ATTGAAGCGCGAATCGTCC -> TTGAAGCGCGAATCGTCCA
ATTGACAGGCTAGTCAGCT -> TTGACAGGCTAGTCAGCTG
ATTGCGATCGCGAGTGTAT -> TTGCGATCGCGAGTGTATC
ATTGGCTCTAGCCGGGCAG -> TTGGCTCTAGCCGGGCAGA
ATTGGGGAATGGCGAGGGT -> TTGGGGAATGGCGAGGGTT
ATTGGGTGACTTTCTAGGG -> TTGGGTGACTTTCTAGGGG
ATTTACTCCCCTTTGTAAG -> TTTACTCCCCTTTGTAAGT
ATTTCATGTGGTGCGAACC -> TTTCATGTGGTGCGAACCG
CAAAACTGCACGTTTGCTG -> AAAACTGCACGTTTGCTGG
CAAACGAATAGTTGGGCCG -> AAACGAATAGTTGGGCCGC
CAAAGCCTACTCATGGCCA -> AAAGCCTACTCATGGCCAA
CAAAGCGTTGCACACCTAC -> AAAGCGTTGCACACCTACA
CAAAGTGCCATACCCTTCT -> AAAGTGCCATACCCTTCTG
CAAATCCAGATATCACCAG -> AAATCCAGATATCACCAGT
CAAATCCCGTGCTTGACCA -> AAATCCCGTGCTTGACCAC
CAACAACCTCTTATTGACA -> AACAACCTCTTATTGACAG
CAACATCTTAACAGCCGGG -> AACATCTTAACAGCCGGGC
CAACCATAATAGGAGCCAC -> AACCATAATAGGAGCCACC
CAACCTCGCCAGGCATAAT -> AACCTCGCCAGGCATAATA
CAACCTCTTATTGACAGGC -> AACCTCTTATTGACAGGCT
CAACCTTCGAACGTGTAGA -> AACCTTCGAACGTGTAGAG
CAACGATGGCCGCGATCCA -> AACGATGGCCGCGATCCAA
CAACGGTAATCAAGACACG -> AACGGTAATCAAGACACGA
CAACTATCAGACATGATAT -> AACTATCAGACATGATATG
CAACTGACCATACGGCGTC -> AACTGACCATACGGCGTCG
CAAGAAAAGCACGAGTATG -> AAGAAAAGCACGAGTATGT
CAAGAAAGTTGGGGGGGTG -> AAGAAAGTTGGGGGGGTGG
CAAGACACGAGCGTCCGGA -> AAGACACGAGCGTCCGGAA
CAAGATACAACTGACCATA -> AAGATACAACTGACCATAC
CAAGCGTATGCCAACGATG -> AAGCGTATGCCAACGATGG
CAAGGTGGGCGGCCTAGAG -> AAGGTGGGCGGCCTAGAGA
CAAGTGACCAATAATCCCA -> AAGTGACCAATAATCCCAA
CAAGTGTTGTGGCGGCTTT -> AAGTGTTGTGGCGGCTTTA
CAATAAAGGATTACGTCTT -> AATAAAGGATTACGTCTTG
CAATAAGGTGTTGTCAGTG -> AATAAGGTGTTGTCAGTGT
CAATAATCCCAACCTTCGA -> AATAATCCCAACCTTCGAA
CAATACCTAGGATACACCT -> AATACCTAGGATACACCTA
CAATAGCCCGTGAGCTTTC -> AATAGCCCGTGAGCTTTCT
CAATAGTTTCGATGCTATC -> AATAGTTTCGATGCTATCG
CAATCGTCTTTCATGTCGA -> AATCGTCTTTCATGTCGAT
CAATCTTGGCGGGTCCCGG -> AATCTTGGCGGGTCCCGGA
CAATGCCCGTCAACAACCT -> AATGCCCGTCAACAACCTC
CAATTAAGCACCGACGGAG -> AATTAAGCACCGACGGAGC
CACAAACGAATAGTTGGGC -> ACAAACGAATAGTTGGGCC
CACAAGAAAGTTGGGGGGG -> ACAAGAAAGTTGGGGGGGT
CACAAGCGTATGCCAACGA -> ACAAGCGTATGCCAACGAT
CACAATACCTAGGATACAC -> ACAATACCTAGGATACACC
CACACAAGAAAGTTGGGGG -> ACACAAGAAAGTTGGGGGG
CACACCTACACTCGCGATG -> ACACCTACACTCGCGATGC
CACAGACTCCGTAGAGACT -> ACAGACTCCGTAGAGACTC
CACAGAGTCCGGCTGAATT -> ACAGAGTCCGGCTGAATTG
CACAGCTACGATTGGCTCT -> ACAGCTACGATTGGCTCTA
CACAGTGGGCAAGGTGGGC -> ACAGTGGGCAAGGTGGGCG
CACAGTTATCACTTGTATT -> ACAGTTATCACTTGTATTC
CACATCTCAGGTGCCATAC -> ACATCTCAGGTGCCATACC
CACCAGTCGCCCGTAACGG -> ACCAGTCGCCCGTAACGGA
CACCCTACAACCTCGCCAG -> ACCCTACAACCTCGCCAGG
CACCGACGGAGCTTCACAG -> ACCGACGGAGCTTCACAGA
CACCGTCCGCTCGAATCTC -> ACCGTCCGCTCGAATCTCA
CACCGTTTGCTTTCCTTAA -> ACCGTTTGCTTTCCTTAAT
CACCTAAGTTTCGTTCAAG -> ACCTAAGTTTCGTTCAAGT
CACCTACACTCGCGATGCC -> ACCTACACTCGCGATGCCA
CACCTTGGTTTAGACCGTA -> ACCTTGGTTTAGACCGTAC
CACGAGCGTCCGGAACAAT -> ACGAGCGTCCGGAACAATG
CACGAGTATGTGATCCCTG -> ACGAGTATGTGATCCCTGG
CACGATTAGTGGCACGGAA -> ACGATTAGTGGCACGGAAT
CACGGAAAAAGTTCTGGAA -> ACGGAAAAAGTTCTGGAAG
CACGGAATCACAATACCTA -> ACGGAATCACAATACCTAG
CACGGTCAATAAGGTGTTG -> ACGGTCAATAAGGTGTTGT
CACGTATCCGTATGCCCAA -> ACGTATCCGTATGCCCAAT
CACGTTGAGAGGCTAGTGT -> ACGTTGAGAGGCTAGTGTA
CACGTTTGCTGGGCCGGCT -> ACGTTTGCTGGGCCGGCTC
CACTATCGACCGGATTAAT -> ACTATCGACCGGATTAATG
CACTATCGTCCTGTCGGCC -> ACTATCGTCCTGTCGGCCA
CACTCACGTATCCGTATGC -> ACTCACGTATCCGTATGCC
CACTCGCGATGCCATAGCG -> ACTCGCGATGCCATAGCGT
CACTGGTCCTGCGGTTGCC -> ACTGGTCCTGCGGTTGCCT
CACTTAGCGAACGGGAGTC -> ACTTAGCGAACGGGAGTCG
CACTTGTATTCAGCCACAG -> ACTTGTATTCAGCCACAGT
CAGAACACCGTCCGCTCGA -> AGAACACCGTCCGCTCGAA
CAGAACTGGAAATAGACTC -> AGAACTGGAAATAGACTCC
CAGAATAGCGATAGACTTT -> AGAATAGCGATAGACTTTT
CAGAATCCTGAAACGGACG -> AGAATCCTGAAACGGACGA
CAGACAGTCGCTCGACGTG -> AGACAGTCGCTCGACGTGA
CAGACATGATATGTACCAG -> AGACATGATATGTACCAGG
CAGACTCCGTAGAGACTCA -> AGACTCCGTAGAGACTCAT
CAGAGCCTCTCGACTTTCG -> AGAGCCTCTCGACTTTCGG
CAGAGCTCAGGGTTCATTC -> AGAGCTCAGGGTTCATTCC
CAGAGGACTAGACAGTGAT -> AGAGGACTAGACAGTGATT
CAGAGTCCGGCTGAATTGC -> AGAGTCCGGCTGAATTGCG
CAGATATCACCAGTCGCCC -> AGATATCACCAGTCGCCCG
CAGCCACACAAGAAAGTTG -> AGCCACACAAGAAAGTTGG
CAGCCACAGTGGGCAAGGT -> AGCCACAGTGGGCAAGGTG
CAGCCGGGCCTTTACATGA -> AGCCGGGCCTTTACATGAG
CAGCCGTCTGGATGTGTGA -> AGCCGTCTGGATGTGTGAT
CAGCCTCAGGCGGAGAGTT -> AGCCTCAGGCGGAGAGTTT
CAGCCTGAGGGTTTTTTTC -> AGCCTGAGGGTTTTTTTCC
CAGCGCGTCTTATACGTCG -> AGCGCGTCTTATACGTCGT
CAGCGTGATTATCTTTGTG -> AGCGTGATTATCTTTGTGC
CAGCTACGATTGGCTCTAG -> AGCTACGATTGGCTCTAGC
CAGCTATGTCTCGTTGGAC -> AGCTATGTCTCGTTGGACG
CAGCTGCTGCTGGGCCCGC -> AGCTGCTGCTGGGCCCGCA
CAGGAAAGCTCTGGCCACT -> AGGAAAGCTCTGGCCACTT
CAGGCATAATAGGACCCGT -> AGGCATAATAGGACCCGTG
CAGGCATTGGGGAATGGCG -> AGGCATTGGGGAATGGCGA
CAGGCGGAGAGTTTGAGTC -> AGGCGGAGAGTTTGAGTCC
CAGGCTAGTCAGCTGCTGC -> AGGCTAGTCAGCTGCTGCT
CAGGGGCACGGAAAAAGTT -> AGGGGCACGGAAAAAGTTC
CAGGGTTCATTCCTTGTAC -> AGGGTTCATTCCTTGTACC
CAGGTGCCATACCCTTCTG -> AGGTGCCATACCCTTCTGC
CAGTCCCCATGCTGTGTTG -> AGTCCCCATGCTGTGTTGG
CAGTCCTACAGAGGACTAG -> AGTCCTACAGAGGACTAGA
CAGTCGCCCGTAACGGACT -> AGTCGCCCGTAACGGACTG
CAGTCGCTCGACGTGAATA -> AGTCGCTCGACGTGAATAA
CAGTGATTAGATTACGTGG -> AGTGATTAGATTACGTGGG
CAGTGGGCAAGGTGGGCGG -> AGTGGGCAAGGTGGGCGGC
CAGTGTCGATGGTCTTGTT -> AGTGTCGATGGTCTTGTTA
CAGTTAGTTAGGCAAAGTG -> AGTTAGTTAGGCAAAGTGC
CAGTTATCACTTGTATTCA -> AGTTATCACTTGTATTCAG
CAGTTCGTTATCTTCGGTG -> AGTTCGTTATCTTCGGTGC
CAGTTGAGGTCAGTCCCCA -> AGTTGAGGTCAGTCCCCAT
CAGTTGCACATCTCAGGTG -> AGTTGCACATCTCAGGTGC
CAGTTGGAAGATTTACTCC -> AGTTGGAAGATTTACTCCC
CAGTTTGTGGAACATAGTG -> AGTTTGTGGAACATAGTGC
CATAAGGACCTCGCGCAGA -> ATAAGGACCTCGCGCAGAA
CATAATAGGACCCGTGGGA -> ATAATAGGACCCGTGGGAG
CATAATAGGAGCCACCGTT -> ATAATAGGAGCCACCGTTT
CATACCCTTCTGCCAATCG -> ATACCCTTCTGCCAATCGT
CATACCCTTCTGCCAGCCT -> ATACCCTTCTGCCAGCCTG
CATACCCTTCTGCCATAAG -> ATACCCTTCTGCCATAAGG
CATACCCTTCTGCCATATA -> ATACCCTTCTGCCATATAA
CATACGGCGTCGACGCGTA -> ATACGGCGTCGACGCGTAT
CATAGAAGTTGATTGGGTG -> ATAGAAGTTGATTGGGTGA
CATAGACCACAGACTCCGT -> ATAGACCACAGACTCCGTA
CATAGCGTACCCTGGGAAT -> ATAGCGTACCCTGGGAATG
CATAGTGCCATACCCTTCT -> ATAGTGCCATACCCTTCTG
CATATAAGTCAGGGGCACG -> ATATAAGTCAGGGGCACGG
CATCACTATCGACCGGATT -> ATCACTATCGACCGGATTA
CATCAGAACACCGTCCGCT -> ATCAGAACACCGTCCGCTC
CATCCAGTTGGAAGATTTA -> ATCCAGTTGGAAGATTTAC
CATCCCAGTTGAGGTCAGT -> ATCCCAGTTGAGGTCAGTC
CATCTCAGGTGCCATACCC -> ATCTCAGGTGCCATACCCT
CATCTTAACAGCCGGGCCT -> ATCTTAACAGCCGGGCCTT
CATGACTTCAAATCCAGAT -> ATGACTTCAAATCCAGATA
CATGAGGGACCAACGGTAA -> ATGAGGGACCAACGGTAAT
CATGATATGTACCAGGCAT -> ATGATATGTACCAGGCATT
CATGCTGTGTTGGGTAACA -> ATGCTGTGTTGGGTAACAG
CATGGATGACCTAACGCGC -> ATGGATGACCTAACGCGCT
CATGGCCAACCATAATAGG -> ATGGCCAACCATAATAGGA
CATGTCGATTAAGCAGCCA -> ATGTCGATTAAGCAGCCAC
CATGTCGGGAATACGACTG -> ATGTCGGGAATACGACTGC
CATGTGGTGCGAACCGGTT -> ATGTGGTGCGAACCGGTTA
CATTCCTTGTACCTGTAGT -> ATTCCTTGTACCTGTAGTT
CATTGGGGAATGGCGAGGG -> ATTGGGGAATGGCGAGGGT
CCAAAGCCTACTCATGGCC -> CAAAGCCTACTCATGGCCA
CCAACATCTTAACAGCCGG -> CAACATCTTAACAGCCGGG
CCAACCATAATAGGAGCCA -> CAACCATAATAGGAGCCAC
CCAACCTTCGAACGTGTAG -> CAACCTTCGAACGTGTAGA
CCAACGATGGCCGCGATCC -> CAACGATGGCCGCGATCCA
CCAACGGTAATCAAGACAC -> CAACGGTAATCAAGACACG
CCAAGAAAAGCACGAGTAT -> CAAGAAAAGCACGAGTATG
CCAATAAAGGATTACGTCT -> CAATAAAGGATTACGTCTT
CCAATAATCCCAACCTTCG -> CAATAATCCCAACCTTCGA
CCAATAGCCCGTGAGCTTT -> CAATAGCCCGTGAGCTTTC
CCAATCGTCTTTCATGTCG -> CAATCGTCTTTCATGTCGA
CCACAAACGAATAGTTGGG -> CACAAACGAATAGTTGGGC
CCACAAGCGTATGCCAACG -> CACAAGCGTATGCCAACGA
CCACACAAGAAAGTTGGGG -> CACACAAGAAAGTTGGGGG
CCACAGACTCCGTAGAGAC -> CACAGACTCCGTAGAGACT
CCACAGTGGGCAAGGTGGG -> CACAGTGGGCAAGGTGGGC
CCACAGTTATCACTTGTAT -> CACAGTTATCACTTGTATT
CCACCGTTTGCTTTCCTTA -> CACCGTTTGCTTTCCTTAA
CCACGATTAGTGGCACGGA -> CACGATTAGTGGCACGGAA
CCACTGGTCCTGCGGTTGC -> CACTGGTCCTGCGGTTGCC
CCACTTAGCGAACGGGAGT -> CACTTAGCGAACGGGAGTC
CCAGACAGTCGCTCGACGT -> CAGACAGTCGCTCGACGTG
CCAGATATCACCAGTCGCC -> CAGATATCACCAGTCGCCC
CCAGCCTCAGGCGGAGAGT -> CAGCCTCAGGCGGAGAGTT
CCAGCCTGAGGGTTTTTTT -> CAGCCTGAGGGTTTTTTTC
CCAGCGCGTCTTATACGTC -> CAGCGCGTCTTATACGTCG
CCAGGAAAGCTCTGGCCAC -> CAGGAAAGCTCTGGCCACT
CCAGGCATAATAGGACCCG -> CAGGCATAATAGGACCCGT
CCAGGCATTGGGGAATGGC -> CAGGCATTGGGGAATGGCG
CCAGTCGCCCGTAACGGAC -> CAGTCGCCCGTAACGGACT
CCAGTTGAGGTCAGTCCCC -> CAGTTGAGGTCAGTCCCCA
CCAGTTGGAAGATTTACTC -> CAGTTGGAAGATTTACTCC
CCATAAGGACCTCGCGCAG -> CATAAGGACCTCGCGCAGA
CCATAATAGGAGCCACCGT -> CATAATAGGAGCCACCGTT
CCATACCCTTCTGCCAATC -> CATACCCTTCTGCCAATCG
CCATACCCTTCTGCCAGCC -> CATACCCTTCTGCCAGCCT
CCATACCCTTCTGCCATAA -> CATACCCTTCTGCCATAAG
CCATACCCTTCTGCCATAT -> CATACCCTTCTGCCATATA
CCATACGGCGTCGACGCGT -> CATACGGCGTCGACGCGTA
CCATAGAAGTTGATTGGGT -> CATAGAAGTTGATTGGGTG
CCATAGCGTACCCTGGGAA -> CATAGCGTACCCTGGGAAT
CCATATAAGTCAGGGGCAC -> CATATAAGTCAGGGGCACG
CCATCCCAGTTGAGGTCAG -> CATCCCAGTTGAGGTCAGT
CCATGACTTCAAATCCAGA -> CATGACTTCAAATCCAGAT
CCATGCTGTGTTGGGTAAC -> CATGCTGTGTTGGGTAACA
CCCAACCTTCGAACGTGTA -> CCAACCTTCGAACGTGTAG
CCCAATAAAGGATTACGTC -> CCAATAAAGGATTACGTCT
CCCAGTTGAGGTCAGTCCC -> CCAGTTGAGGTCAGTCCCC
CCCATGCTGTGTTGGGTAA -> CCATGCTGTGTTGGGTAAC
CCCCATGCTGTGTTGGGTA -> CCCATGCTGTGTTGGGTAA
CCCCTTTGAACACGGTCAA -> CCCTTTGAACACGGTCAAT
CCCCTTTGTAAGTCGGGGG -> CCCTTTGTAAGTCGGGGGA
CCCGCAGTCCTACAGAGGA -> CCGCAGTCCTACAGAGGAC
CCCGGAACCAGCCTCAGGC -> CCGGAACCAGCCTCAGGCG
CCCGTAACGGACTGGTGTG -> CCGTAACGGACTGGTGTGG
CCCGTCAACAACCTCTTAT -> CCGTCAACAACCTCTTATT
CCCGTGAGCTTTCTTTCTA -> CCGTGAGCTTTCTTTCTAG
CCCGTGCTTGACCACAAAC -> CCGTGCTTGACCACAAACG
CCCGTGGGAGATCGAGCTA -> CCGTGGGAGATCGAGCTAC
CCCTACAACCTCGCCAGGC -> CCTACAACCTCGCCAGGCA
CCCTGCCTACTACAGAATC -> CCTGCCTACTACAGAATCC
CCCTGGATGTGTGATCAGT -> CCTGGATGTGTGATCAGTT
CCCTGGGAATGTAGCAAGA -> CCTGGGAATGTAGCAAGAT
CCCTTCTGCCAATCGTCTT -> CCTTCTGCCAATCGTCTTT
CCCTTCTGCCAGCCTGAGG -> CCTTCTGCCAGCCTGAGGG
CCCTTCTGCCATAAGGACC -> CCTTCTGCCATAAGGACCT
CCCTTCTGCCATATAAGTC -> CCTTCTGCCATATAAGTCA
CCCTTTGAACACGGTCAAT -> CCTTTGAACACGGTCAATA
CCCTTTGTAAGTCGGGGGA -> CCTTTGTAAGTCGGGGGAC
CCGACGGAGCTTCACAGAG -> CGACGGAGCTTCACAGAGT
CCGCAGTCCTACAGAGGAC -> CGCAGTCCTACAGAGGACT
CCGCGATCCAAGAAAAGCA -> CGCGATCCAAGAAAAGCAC
CCGCGGGCGTCCAGCGCGT -> CGCGGGCGTCCAGCGCGTC
CCGCTCGAATCTCAAAGCG -> CGCTCGAATCTCAAAGCGT
CCGGAACAATGCCCGTCAA -> CGGAACAATGCCCGTCAAC
CCGGAACCAGCCTCAGGCG -> CGGAACCAGCCTCAGGCGG
CCGGATTAATGCGAACTTC -> CGGATTAATGCGAACTTCC
CCGGCAAGTGTTGTGGCGG -> CGGCAAGTGTTGTGGCGGC
CCGGCTCCATGACTTCAAA -> CGGCTCCATGACTTCAAAT
CCGGCTGAATTGCGATCGC -> CGGCTGAATTGCGATCGCG
CCGGGCAGAACTGGAAATA -> CGGGCAGAACTGGAAATAG
CCGGGCCTTTACATGAGGG -> CGGGCCTTTACATGAGGGA
CCGGGTTATTATCTATCTC -> CGGGTTATTATCTATCTCG
CCGGTTAATCGTGCTGTAT -> CGGTTAATCGTGCTGTATG
CCGTAACGGACTGGTGTGG -> CGTAACGGACTGGTGTGGC
CCGTACCGGCAAGTGTTGT -> CGTACCGGCAAGTGTTGTG
CCGTAGAGACTCATGGATG -> CGTAGAGACTCATGGATGA
CCGTATGCCCAATAAAGGA -> CGTATGCCCAATAAAGGAT
CCGTCAACAACCTCTTATT -> CGTCAACAACCTCTTATTG
CCGTCCGCTCGAATCTCAA -> CGTCCGCTCGAATCTCAAA
CCGTCTGGATGTGTGATCA -> CGTCTGGATGTGTGATCAG
CCGTGAGCTTTCTTTCTAG -> CGTGAGCTTTCTTTCTAGG
CCGTGCTTGACCACAAACG -> CGTGCTTGACCACAAACGA
CCGTGGGAGATCGAGCTAC -> CGTGGGAGATCGAGCTACT
CCGTTTGCTTTCCTTAATA -> CGTTTGCTTTCCTTAATAC
CCTAACGCGCTGTTTAATG -> CTAACGCGCTGTTTAATGT
CCTAAGTTTCGTTCAAGTG -> CTAAGTTTCGTTCAAGTGA
CCTACAACCTCGCCAGGCA -> CTACAACCTCGCCAGGCAT
CCTACACTCGCGATGCCAT -> CTACACTCGCGATGCCATA
CCTACAGAGGACTAGACAG -> CTACAGAGGACTAGACAGT
CCTACTACAGAATCCTGAA -> CTACTACAGAATCCTGAAA
CCTACTCATGGCCAACCAT -> CTACTCATGGCCAACCATA
CCTAGAGAGTGTTCCACAA -> CTAGAGAGTGTTCCACAAG
CCTAGCATCACTATCGACC -> CTAGCATCACTATCGACCG
CCTAGGATACACCTAAGTT -> CTAGGATACACCTAAGTTT
CCTCAGGCGGAGAGTTTGA -> CTCAGGCGGAGAGTTTGAG
CCTCCCTGCCTACTACAGA -> CTCCCTGCCTACTACAGAA
CCTCGCCAGGCATAATAGG -> CTCGCCAGGCATAATAGGA
CCTCGCGCAGAATAGCGAT -> CTCGCGCAGAATAGCGATA
CCTCGGGACATGTCGGGAA -> CTCGGGACATGTCGGGAAT
CCTCTCGACTTTCGGTTAC -> CTCTCGACTTTCGGTTACT
CCTCTTATTGACAGGCTAG -> CTCTTATTGACAGGCTAGT
CCTGAAACGGACGATTCAG -> CTGAAACGGACGATTCAGC
CCTGAGGGTTTTTTTCCCC -> CTGAGGGTTTTTTTCCCCT
CCTGCCTACTACAGAATCC -> CTGCCTACTACAGAATCCT
CCTGCGGTTGCCTGCTTCA -> CTGCGGTTGCCTGCTTCAC
CCTGCTTCACTATCGTCCT -> CTGCTTCACTATCGTCCTG
CCTGGATGTGTGATCAGTT -> CTGGATGTGTGATCAGTTC
CCTGGGAATGTAGCAAGAT -> CTGGGAATGTAGCAAGATA
CCTGGTCACCCTACAACCT -> CTGGTCACCCTACAACCTC
CCTGTAGTTACCAAAGCCT -> CTGTAGTTACCAAAGCCTA
CCTGTCGGCCAGACAGTCG -> CTGTCGGCCAGACAGTCGC
CCTTAATACCATAGAAGTT -> CTTAATACCATAGAAGTTG
CCTTCGAACGTGTAGAGTT -> CTTCGAACGTGTAGAGTTT
CCTTCTGCCAATCGTCTTT -> CTTCTGCCAATCGTCTTTC
CCTTCTGCCAGCCTGAGGG -> CTTCTGCCAGCCTGAGGGT
CCTTCTGCCATAAGGACCT -> CTTCTGCCATAAGGACCTC
CCTTCTGCCATATAAGTCA -> CTTCTGCCATATAAGTCAG
CCTTGAACACGTTGAGAGG -> CTTGAACACGTTGAGAGGC
CCTTGGTTTAGACCGTACC -> CTTGGTTTAGACCGTACCG
CCTTGTACCTGTAGTTACC -> CTTGTACCTGTAGTTACCA
CCTTTACATGAGGGACCAA -> CTTTACATGAGGGACCAAC
CCTTTGAACACGGTCAATA -> CTTTGAACACGGTCAATAA
CCTTTGTAAGTCGGGGGAC -> CTTTGTAAGTCGGGGGACG
CGAACAGCTATGTCTCGTT -> GAACAGCTATGTCTCGTTG
CGAACCGGTTAATCGTGCT -> GAACCGGTTAATCGTGCTG
CGAACGGGAGTCGACTAAA -> GAACGGGAGTCGACTAAAA
CGAACGTGTAGAGTTTAGA -> GAACGTGTAGAGTTTAGAC
CGAACTTCCAGTCATGCTA -> GAACTTCCAGTCATGCTAG
CGAATAGTTGGGCCGCGGG -> GAATAGTTGGGCCGCGGGC
CGAATCGTCCAACATCTTA -> GAATCGTCCAACATCTTAA
CGAATCTCAAAGCGTTGCA -> GAATCTCAAAGCGTTGCAC
CGACCGGATTAATGCGAAC -> GACCGGATTAATGCGAACT
CGACGCGTATATATGCCTA -> GACGCGTATATATGCCTAG
CGACGGAGCTTCACAGAGT -> GACGGAGCTTCACAGAGTC
CGACGTGAATAAGGATCTT -> GACGTGAATAAGGATCTTG
CGACTAAAATTGAAGCGCG -> GACTAAAATTGAAGCGCGA
CGACTGCAAATCCCGTGCT -> GACTGCAAATCCCGTGCTT
CGACTTTCGGTTACTGGAT -> GACTTTCGGTTACTGGATG
CGAGCGTCCGGAACAATGC -> GAGCGTCCGGAACAATGCC
CGAGCTACTTCATAGACCA -> GAGCTACTTCATAGACCAC
CGAGGGGGCACTCACGTAT -> GAGGGGGCACTCACGTATC
CGAGGGTTTATCGATAGGA -> GAGGGTTTATCGATAGGAG
CGAGTAAGGAATTCCACTG -> GAGTAAGGAATTCCACTGG
CGAGTATGTGATCCCTGGA -> GAGTATGTGATCCCTGGAT
CGAGTGTATCGGGATGTGC -> GAGTGTATCGGGATGTGCA
CGATAGACTTTTCGGGAAT -> GATAGACTTTTCGGGAATC
CGATAGGAGTTATACTCTC -> GATAGGAGTTATACTCTCT
CGATCCAAGAAAAGCACGA -> GATCCAAGAAAAGCACGAG
CGATCGCGAGTGTATCGGG -> GATCGCGAGTGTATCGGGA
CGATGCCATAGCGTACCCT -> GATGCCATAGCGTACCCTG
CGATGCTATCGGTCATCCA -> GATGCTATCGGTCATCCAG
CGATGGCCGCGATCCAAGA -> GATGGCCGCGATCCAAGAA
CGATGGTCTTGTTAGAATA -> GATGGTCTTGTTAGAATAA
CGATTAAGCAGCCACACAA -> GATTAAGCAGCCACACAAG
CGATTAGTGGCACGGAATC -> GATTAGTGGCACGGAATCA
CGATTCAGCGTGATTATCT -> GATTCAGCGTGATTATCTT
CGATTGGCTCTAGCCGGGC -> GATTGGCTCTAGCCGGGCA
CGCAGAATAGCGATAGACT -> GCAGAATAGCGATAGACTT
CGCAGTCCTACAGAGGACT -> GCAGTCCTACAGAGGACTA
CGCCAGGCATAATAGGACC -> GCCAGGCATAATAGGACCC
CGCCCGTAACGGACTGGTG -> GCCCGTAACGGACTGGTGT
CGCGAATCGTCCAACATCT -> GCGAATCGTCCAACATCTT
CGCGAGTGTATCGGGATGT -> GCGAGTGTATCGGGATGTG
CGCGATCCAAGAAAAGCAC -> GCGATCCAAGAAAAGCACG
CGCGATGCCATAGCGTACC -> GCGATGCCATAGCGTACCC
CGCGCAGAATAGCGATAGA -> GCGCAGAATAGCGATAGAC
CGCGCTGTTTAATGTCCAC -> GCGCTGTTTAATGTCCACA
CGCGGGCGTCCAGCGCGTC -> GCGGGCGTCCAGCGCGTCT
CGCGTATATATGCCTAGCA -> GCGTATATATGCCTAGCAT
CGCGTCTTATACGTCGTCG -> GCGTCTTATACGTCGTCGG
CGCGTGGGCTCAACTATCA -> GCGTGGGCTCAACTATCAG
CGCTCGAATCTCAAAGCGT -> GCTCGAATCTCAAAGCGTT
CGCTCGACGTGAATAAGGA -> GCTCGACGTGAATAAGGAT
CGCTGGATGTGTGATCAGT -> GCTGGATGTGTGATCAGTT
CGCTGTTTAATGTCCACAG -> GCTGTTTAATGTCCACAGT
CGGAAAAAGTTCTGGAAGC -> GGAAAAAGTTCTGGAAGCC
CGGAACAATGCCCGTCAAC -> GGAACAATGCCCGTCAACA
CGGAACCAGCCTCAGGCGG -> GGAACCAGCCTCAGGCGGA
CGGAATCACAATACCTAGG -> GGAATCACAATACCTAGGA
CGGACGATTCAGCGTGATT -> GGACGATTCAGCGTGATTA
CGGACTGGTGTGGCAGAGC -> GGACTGGTGTGGCAGAGCC
CGGAGAGTTTGAGTCCATC -> GGAGAGTTTGAGTCCATCC
CGGAGCTTCACAGAGTCCG -> GGAGCTTCACAGAGTCCGG
CGGATTAAATCCACGATTA -> GGATTAAATCCACGATTAG
CGGATTAATGCGAACTTCC -> GGATTAATGCGAACTTCCA
CGGCAAGTGTTGTGGCGGC -> GGCAAGTGTTGTGGCGGCT
CGGCCAGACAGTCGCTCGA -> GGCCAGACAGTCGCTCGAC
CGGCCTAGAGAGTGTTCCA -> GGCCTAGAGAGTGTTCCAC
CGGCCTGGTCACCCTACAA -> GGCCTGGTCACCCTACAAC
CGGCGTCGACGCGTATATA -> GGCGTCGACGCGTATATAT
CGGCTCCATGACTTCAAAT -> GGCTCCATGACTTCAAATC
CGGCTGAATTGCGATCGCG -> GGCTGAATTGCGATCGCGA
CGGCTTTAACTACAATTAA -> GGCTTTAACTACAATTAAG
CGGGAACCTTGAACACGTT -> GGGAACCTTGAACACGTTG
CGGGAATACGACTGCAAAT -> GGGAATACGACTGCAAATC
CGGGAATCGTTGCCTCCCT -> GGGAATCGTTGCCTCCCTG
CGGGACATGTCGGGAATAC -> GGGACATGTCGGGAATACG
CGGGAGTCGACTAAAATTG -> GGGAGTCGACTAAAATTGA
CGGGATGTGCAAAACTGCA -> GGGATGTGCAAAACTGCAC
CGGGCAGAACTGGAAATAG -> GGGCAGAACTGGAAATAGA
CGGGCCTTTACATGAGGGA -> GGGCCTTTACATGAGGGAC
CGGGCGTCCAGCGCGTCTT -> GGGCGTCCAGCGCGTCTTA
CGGGGGACGGCCTGGTCAC -> GGGGGACGGCCTGGTCACC
CGGGTCCCGGAACCAGCCT -> GGGTCCCGGAACCAGCCTC
CGGGTTATTATCTATCTCG -> GGGTTATTATCTATCTCGA
CGGTAATCAAGACACGAGC -> GGTAATCAAGACACGAGCG
CGGTCAATAAGGTGTTGTC -> GGTCAATAAGGTGTTGTCA
CGGTCATCCAGTTGGAAGA -> GGTCATCCAGTTGGAAGAT
CGGTGCCATACCCTTCTGC -> GGTGCCATACCCTTCTGCC
CGGTTAATCGTGCTGTATG -> GGTTAATCGTGCTGTATGT
CGGTTACTGGATGTGTGAT -> GGTTACTGGATGTGTGATC
CGGTTGCCTGCTTCACTAT -> GGTTGCCTGCTTCACTATC
CGTAACGGACTGGTGTGGC -> GTAACGGACTGGTGTGGCA
CGTACCCTGGGAATGTAGC -> GTACCCTGGGAATGTAGCA
CGTACCGGCAAGTGTTGTG -> GTACCGGCAAGTGTTGTGG
CGTACTGTAGCCTCGGGAC -> GTACTGTAGCCTCGGGACA
CGTAGAGACTCATGGATGA -> GTAGAGACTCATGGATGAC
CGTATATATGCCTAGCATC -> GTATATATGCCTAGCATCA
CGTATCCGTATGCCCAATA -> GTATCCGTATGCCCAATAA
CGTATGCCAACGATGGCCG -> GTATGCCAACGATGGCCGC
CGTATGCCCAATAAAGGAT -> GTATGCCCAATAAAGGATT
CGTCAACAACCTCTTATTG -> GTCAACAACCTCTTATTGA
CGTCCAACATCTTAACAGC -> GTCCAACATCTTAACAGCC
CGTCCAGCGCGTCTTATAC -> GTCCAGCGCGTCTTATACG
CGTCCGCTCGAATCTCAAA -> GTCCGCTCGAATCTCAAAG
CGTCCGGAACAATGCCCGT -> GTCCGGAACAATGCCCGTC
CGTCCTGTCGGCCAGACAG -> GTCCTGTCGGCCAGACAGT
CGTCGACGCGTATATATGC -> GTCGACGCGTATATATGCC
CGTCGGATTAAATCCACGA -> GTCGGATTAAATCCACGAT
CGTCGTCGGATTAAATCCA -> GTCGTCGGATTAAATCCAC
CGTCTGGATGTGTGATCAG -> GTCTGGATGTGTGATCAGT
CGTCTTATACGTCGTCGGA -> GTCTTATACGTCGTCGGAT
CGTCTTGTGAAACATCAGA -> GTCTTGTGAAACATCAGAA
CGTCTTTCATGTCGATTAA -> GTCTTTCATGTCGATTAAG
CGTGAATAAGGATCTTGTG -> GTGAATAAGGATCTTGTGG
CGTGAGCTTTCTTTCTAGG -> GTGAGCTTTCTTTCTAGGC
CGTGATTATCTTTGTGCGT -> GTGATTATCTTTGTGCGTG
CGTGCTGTATGTACAATCT -> GTGCTGTATGTACAATCTT
CGTGCTTGACCACAAACGA -> GTGCTTGACCACAAACGAA
CGTGGGAGATCGAGCTACT -> GTGGGAGATCGAGCTACTT
CGTGGGAGCAATAGTTTCG -> GTGGGAGCAATAGTTTCGA
CGTGGGCTCAACTATCAGA -> GTGGGCTCAACTATCAGAC
CGTGTAGAGTTTAGACGAA -> GTGTAGAGTTTAGACGAAC
CGTGTTTTCGTACTGTAGC -> GTGTTTTCGTACTGTAGCC
CGTTATCTTCGGTGCCATA -> GTTATCTTCGGTGCCATAC
CGTTCAAGTGACCAATAAT -> GTTCAAGTGACCAATAATC
CGTTGAGAGGCTAGTGTAT -> GTTGAGAGGCTAGTGTATT
CGTTGCACACCTACACTCG -> GTTGCACACCTACACTCGC
CGTTGCCTCCCTGCCTACT -> GTTGCCTCCCTGCCTACTA
CGTTGGACGCGTGGGCTCA -> GTTGGACGCGTGGGCTCAA
CGTTTGCTGGGCCGGCTCC -> GTTTGCTGGGCCGGCTCCA
CGTTTGCTTTCCTTAATAC -> GTTTGCTTTCCTTAATACC
CTAAAATTGAAGCGCGAAT -> TAAAATTGAAGCGCGAATC
CTAACGCGCTGTTTAATGT -> TAACGCGCTGTTTAATGTC
CTAAGTTTCGTTCAAGTGA -> TAAGTTTCGTTCAAGTGAC
CTACAACCTCGCCAGGCAT -> TACAACCTCGCCAGGCATA
CTACAATTAAGCACCGACG -> TACAATTAAGCACCGACGG
CTACACTCGCGATGCCATA -> TACACTCGCGATGCCATAG
CTACAGAATCCTGAAACGG -> TACAGAATCCTGAAACGGA
CTACAGAGGACTAGACAGT -> TACAGAGGACTAGACAGTG
CTACGATTGGCTCTAGCCG -> TACGATTGGCTCTAGCCGG
CTACTACAGAATCCTGAAA -> TACTACAGAATCCTGAAAC
CTACTCATGGCCAACCATA -> TACTCATGGCCAACCATAA
CTACTTCATAGACCACAGA -> TACTTCATAGACCACAGAC
CTAGACAGTGATTAGATTA -> TAGACAGTGATTAGATTAC
CTAGAGAGTGTTCCACAAG -> TAGAGAGTGTTCCACAAGC
CTAGCATCACTATCGACCG -> TAGCATCACTATCGACCGG
CTAGCCGGGCAGAACTGGA -> TAGCCGGGCAGAACTGGAA
CTAGGATACACCTAAGTTT -> TAGGATACACCTAAGTTTC
CTAGGCGCTGGATGTGTGA -> TAGGCGCTGGATGTGTGAT
CTAGGGGTCCAATAGCCCG -> TAGGGGTCCAATAGCCCGT
CTAGTCAGCTGCTGCTGGG -> TAGTCAGCTGCTGCTGGGC
CTAGTGTATTTCATGTGGT -> TAGTGTATTTCATGTGGTG
CTATCAGACATGATATGTA -> TATCAGACATGATATGTAC
CTATCGACCGGATTAATGC -> TATCGACCGGATTAATGCG
CTATCGGTCATCCAGTTGG -> TATCGGTCATCCAGTTGGA
CTATCGTCCTGTCGGCCAG -> TATCGTCCTGTCGGCCAGA
CTATCTCGAGGGGGCACTC -> TATCTCGAGGGGGCACTCA
CTATGTCTCGTTGGACGCG -> TATGTCTCGTTGGACGCGT
CTCAAAGCGTTGCACACCT -> TCAAAGCGTTGCACACCTA
CTCAACTATCAGACATGAT -> TCAACTATCAGACATGATA
CTCACGTATCCGTATGCCC -> TCACGTATCCGTATGCCCA
CTCAGGCGGAGAGTTTGAG -> TCAGGCGGAGAGTTTGAGT
CTCAGGGTTCATTCCTTGT -> TCAGGGTTCATTCCTTGTA
CTCAGGTGCCATACCCTTC -> TCAGGTGCCATACCCTTCT
CTCATGGATGACCTAACGC -> TCATGGATGACCTAACGCG
CTCATGGCCAACCATAATA -> TCATGGCCAACCATAATAG
CTCCAGGAAAGCTCTGGCC -> TCCAGGAAAGCTCTGGCCA
CTCCATGACTTCAAATCCA -> TCCATGACTTCAAATCCAG
CTCCCCTTTGTAAGTCGGG -> TCCCCTTTGTAAGTCGGGG
CTCCCTGCCTACTACAGAA -> TCCCTGCCTACTACAGAAT
CTCCGTAGAGACTCATGGA -> TCCGTAGAGACTCATGGAT
CTCGAATCTCAAAGCGTTG -> TCGAATCTCAAAGCGTTGC
CTCGACGTGAATAAGGATC -> TCGACGTGAATAAGGATCT
CTCGACTTTCGGTTACTGG -> TCGACTTTCGGTTACTGGA
CTCGAGGGGGCACTCACGT -> TCGAGGGGGCACTCACGTA
CTCGCCAGGCATAATAGGA -> TCGCCAGGCATAATAGGAC
CTCGCGATGCCATAGCGTA -> TCGCGATGCCATAGCGTAC
CTCGCGCAGAATAGCGATA -> TCGCGCAGAATAGCGATAG
CTCGGGACATGTCGGGAAT -> TCGGGACATGTCGGGAATA
CTCGTTGGACGCGTGGGCT -> TCGTTGGACGCGTGGGCTC
CTCTAGCCGGGCAGAACTG -> TCTAGCCGGGCAGAACTGG
CTCTCGACTTTCGGTTACT -> TCTCGACTTTCGGTTACTG
CTCTCTGGTAATCACAGCT -> TCTCTGGTAATCACAGCTA
CTCTGGCCACTTAGCGAAC -> TCTGGCCACTTAGCGAACG
CTCTGGTAATCACAGCTAC -> TCTGGTAATCACAGCTACG
CTCTTATTGACAGGCTAGT -> TCTTATTGACAGGCTAGTC
CTGAAACGGACGATTCAGC -> TGAAACGGACGATTCAGCG
CTGAATTGCGATCGCGAGT -> TGAATTGCGATCGCGAGTG
CTGACCATACGGCGTCGAC -> TGACCATACGGCGTCGACG
CTGAGGGTTTTTTTCCCCT -> TGAGGGTTTTTTTCCCCTT
CTGCAAATCCCGTGCTTGA -> TGCAAATCCCGTGCTTGAC
CTGCACGTTTGCTGGGCCG -> TGCACGTTTGCTGGGCCGG
CTGCCAATCGTCTTTCATG -> TGCCAATCGTCTTTCATGT
CTGCCAGCCTGAGGGTTTT -> TGCCAGCCTGAGGGTTTTT
CTGCCATAAGGACCTCGCG -> TGCCATAAGGACCTCGCGC
CTGCCATATAAGTCAGGGG -> TGCCATATAAGTCAGGGGC
CTGCCTACTACAGAATCCT -> TGCCTACTACAGAATCCTG
CTGCGGTTGCCTGCTTCAC -> TGCGGTTGCCTGCTTCACT
CTGCTGCTGGGCCCGCAGT -> TGCTGCTGGGCCCGCAGTC
CTGCTGGGCCCGCAGTCCT -> TGCTGGGCCCGCAGTCCTA
CTGCTTCACTATCGTCCTG -> TGCTTCACTATCGTCCTGT
CTGGAAATAGACTCCAGGA -> TGGAAATAGACTCCAGGAA
CTGGAAGCCGGGTTATTAT -> TGGAAGCCGGGTTATTATC
CTGGATGTGTGATCAGTTA -> TGGATGTGTGATCAGTTAG
CTGGATGTGTGATCAGTTC -> TGGATGTGTGATCAGTTCG
CTGGATGTGTGATCAGTTG -> TGGATGTGTGATCAGTTGC
CTGGATGTGTGATCAGTTT -> TGGATGTGTGATCAGTTTG
CTGGCCACTTAGCGAACGG -> TGGCCACTTAGCGAACGGG
CTGGGAATGTAGCAAGATA -> TGGGAATGTAGCAAGATAC
CTGGGCCCGCAGTCCTACA -> TGGGCCCGCAGTCCTACAG
CTGGGCCGGCTCCATGACT -> TGGGCCGGCTCCATGACTT
CTGGTAATCACAGCTACGA -> TGGTAATCACAGCTACGAT
CTGGTCACCCTACAACCTC -> TGGTCACCCTACAACCTCG
CTGGTCCTGCGGTTGCCTG -> TGGTCCTGCGGTTGCCTGC
CTGGTGTGGCAGAGCCTCT -> TGGTGTGGCAGAGCCTCTC
CTGTAGCCTCGGGACATGT -> TGTAGCCTCGGGACATGTC
CTGTAGTTACCAAAGCCTA -> TGTAGTTACCAAAGCCTAC
CTGTATGTACAATCTTGGC -> TGTATGTACAATCTTGGCG
CTGTCGGCCAGACAGTCGC -> TGTCGGCCAGACAGTCGCT
CTGTGTTGGGTAACAGAGC -> TGTGTTGGGTAACAGAGCT
CTGTTTAATGTCCACAGTT -> TGTTTAATGTCCACAGTTA
CTTAACAGCCGGGCCTTTA -> TTAACAGCCGGGCCTTTAC
CTTAATACCATAGAAGTTG -> TTAATACCATAGAAGTTGA
CTTAGCGAACGGGAGTCGA -> TTAGCGAACGGGAGTCGAC
CTTATACGTCGTCGGATTA -> TTATACGTCGTCGGATTAA
CTTATTGACAGGCTAGTCA -> TTATTGACAGGCTAGTCAG
CTTCAAATCCAGATATCAC -> TTCAAATCCAGATATCACC
CTTCACAGAGTCCGGCTGA -> TTCACAGAGTCCGGCTGAA
CTTCACTATCGTCCTGTCG -> TTCACTATCGTCCTGTCGG
CTTCATAGACCACAGACTC -> TTCATAGACCACAGACTCC
CTTCGAACGTGTAGAGTTT -> TTCGAACGTGTAGAGTTTA
CTTCGGTGCCATACCCTTC -> TTCGGTGCCATACCCTTCT
CTTCTGCCAATCGTCTTTC -> TTCTGCCAATCGTCTTTCA
CTTCTGCCAGCCTGAGGGT -> TTCTGCCAGCCTGAGGGTT
CTTCTGCCATAAGGACCTC -> TTCTGCCATAAGGACCTCG
CTTCTGCCATATAAGTCAG -> TTCTGCCATATAAGTCAGG
CTTGAACACGTTGAGAGGC -> TTGAACACGTTGAGAGGCT
CTTGACCACAAACGAATAG -> TTGACCACAAACGAATAGT
CTTGGCGGGTCCCGGAACC -> TTGGCGGGTCCCGGAACCA
CTTGGTTTAGACCGTACCG -> TTGGTTTAGACCGTACCGG
CTTGTACCTGTAGTTACCA -> TTGTACCTGTAGTTACCAA
CTTGTATTCAGCCACAGTG -> TTGTATTCAGCCACAGTGG
CTTGTGAAACATCAGAACA -> TTGTGAAACATCAGAACAC
CTTGTGGCAGCCGTCTGGA -> TTGTGGCAGCCGTCTGGAT
CTTGTTAGAATAATACGGG -> TTGTTAGAATAATACGGGA
CTTTAACTACAATTAAGCA -> TTTAACTACAATTAAGCAC
CTTTACATGAGGGACCAAC -> TTTACATGAGGGACCAACG
CTTTCATGTCGATTAAGCA -> TTTCATGTCGATTAAGCAG
CTTTCCTTAATACCATAGA -> TTTCCTTAATACCATAGAA
CTTTCGGTTACTGGATGTG -> TTTCGGTTACTGGATGTGT
CTTTCTAGGCGCTGGATGT -> TTTCTAGGCGCTGGATGTG
CTTTCTAGGGGTCCAATAG -> TTTCTAGGGGTCCAATAGC
CTTTCTTTCTAGGCGCTGG -> TTTCTTTCTAGGCGCTGGA
CTTTGAACACGGTCAATAA -> TTTGAACACGGTCAATAAG
CTTTGTAAGTCGGGGGACG -> TTTGTAAGTCGGGGGACGG
CTTTGTGCGTGTTTTCGTA -> TTTGTGCGTGTTTTCGTAC
CTTTTCGGGAATCGTTGCC -> TTTTCGGGAATCGTTGCCT
GAAAAAGTTCTGGAAGCCG -> AAAAAGTTCTGGAAGCCGG
GAAAAGCACGAGTATGTGA -> AAAAGCACGAGTATGTGAT
GAAACATCAGAACACCGTC -> AAACATCAGAACACCGTCC
GAAACGGACGATTCAGCGT -> AAACGGACGATTCAGCGTG
GAAAGCTCTGGCCACTTAG -> AAAGCTCTGGCCACTTAGC
GAAAGTTGGGGGGGTGGCG -> AAAGTTGGGGGGGTGGCGA
GAAATAGACTCCAGGAAAG -> AAATAGACTCCAGGAAAGC
GAACAATGCCCGTCAACAA -> AACAATGCCCGTCAACAAC
GAACACCGTCCGCTCGAAT -> AACACCGTCCGCTCGAATC
GAACACGGTCAATAAGGTG -> AACACGGTCAATAAGGTGT
GAACACGTTGAGAGGCTAG -> AACACGTTGAGAGGCTAGT
GAACAGCTATGTCTCGTTG -> AACAGCTATGTCTCGTTGG
GAACATAGTGCCATACCCT -> AACATAGTGCCATACCCTT
GAACCAGCCTCAGGCGGAG -> AACCAGCCTCAGGCGGAGA
GAACCGGTTAATCGTGCTG -> AACCGGTTAATCGTGCTGT
GAACCTTGAACACGTTGAG -> AACCTTGAACACGTTGAGA
GAACGGGAGTCGACTAAAA -> AACGGGAGTCGACTAAAAT
GAACGTGTAGAGTTTAGAC -> AACGTGTAGAGTTTAGACG
GAACTGGAAATAGACTCCA -> AACTGGAAATAGACTCCAG
GAACTTCCAGTCATGCTAG -> AACTTCCAGTCATGCTAGA
GAAGATTTACTCCCCTTTG -> AAGATTTACTCCCCTTTGT
GAAGCCGGGTTATTATCTA -> AAGCCGGGTTATTATCTAT
GAAGCGCGAATCGTCCAAC -> AAGCGCGAATCGTCCAACA
GAAGTTGATTGGGTGACTT -> AAGTTGATTGGGTGACTTT
GAATAAGGATCTTGTGGCA -> AATAAGGATCTTGTGGCAG
GAATAATACGGGAACCTTG -> AATAATACGGGAACCTTGA
GAATACGACTGCAAATCCC -> AATACGACTGCAAATCCCG
GAATAGCGATAGACTTTTC -> AATAGCGATAGACTTTTCG
GAATAGTTGGGCCGCGGGC -> AATAGTTGGGCCGCGGGCG
GAATCACAATACCTAGGAT -> AATCACAATACCTAGGATA
GAATCCTGAAACGGACGAT -> AATCCTGAAACGGACGATT
GAATCGTCCAACATCTTAA -> AATCGTCCAACATCTTAAC
GAATCGTTGCCTCCCTGCC -> AATCGTTGCCTCCCTGCCT
GAATCTCAAAGCGTTGCAC -> AATCTCAAAGCGTTGCACA
GAATGGCGAGGGTTTATCG -> AATGGCGAGGGTTTATCGA
GAATGTAGCAAGATACAAC -> AATGTAGCAAGATACAACT
GAATTCCACTGGTCCTGCG -> AATTCCACTGGTCCTGCGG
GAATTGCGATCGCGAGTGT -> AATTGCGATCGCGAGTGTA
GACACGAGCGTCCGGAACA -> ACACGAGCGTCCGGAACAA
GACAGGCTAGTCAGCTGCT -> ACAGGCTAGTCAGCTGCTG
GACAGTCGCTCGACGTGAA -> ACAGTCGCTCGACGTGAAT
GACAGTGATTAGATTACGT -> ACAGTGATTAGATTACGTG
GACATGATATGTACCAGGC -> ACATGATATGTACCAGGCA
GACATGTCGGGAATACGAC -> ACATGTCGGGAATACGACT
GACCAACGGTAATCAAGAC -> ACCAACGGTAATCAAGACA
GACCAATAATCCCAACCTT -> ACCAATAATCCCAACCTTC
GACCACAAACGAATAGTTG -> ACCACAAACGAATAGTTGG
GACCACAGACTCCGTAGAG -> ACCACAGACTCCGTAGAGA
GACCATACGGCGTCGACGC -> ACCATACGGCGTCGACGCG
GACCCGTGGGAGATCGAGC -> ACCCGTGGGAGATCGAGCT
GACCGGATTAATGCGAACT -> ACCGGATTAATGCGAACTT
GACCGTACCGGCAAGTGTT -> ACCGTACCGGCAAGTGTTG
GACCTAACGCGCTGTTTAA -> ACCTAACGCGCTGTTTAAT
GACCTCGCGCAGAATAGCG -> ACCTCGCGCAGAATAGCGA
GACGAACAGCTATGTCTCG -> ACGAACAGCTATGTCTCGT
GACGATTCAGCGTGATTAT -> ACGATTCAGCGTGATTATC
GACGCGTATATATGCCTAG -> ACGCGTATATATGCCTAGC
GACGCGTGGGCTCAACTAT -> ACGCGTGGGCTCAACTATC
GACGGAGCTTCACAGAGTC -> ACGGAGCTTCACAGAGTCC
GACGGCCTGGTCACCCTAC -> ACGGCCTGGTCACCCTACA
GACGTGAATAAGGATCTTG -> ACGTGAATAAGGATCTTGT
GACTAAAATTGAAGCGCGA -> ACTAAAATTGAAGCGCGAA
GACTAGACAGTGATTAGAT -> ACTAGACAGTGATTAGATT
GACTCATGGATGACCTAAC -> ACTCATGGATGACCTAACG
GACTCCAGGAAAGCTCTGG -> ACTCCAGGAAAGCTCTGGC
GACTCCGTAGAGACTCATG -> ACTCCGTAGAGACTCATGG
GACTGCAAATCCCGTGCTT -> ACTGCAAATCCCGTGCTTG
GACTGGTGTGGCAGAGCCT -> ACTGGTGTGGCAGAGCCTC
GACTTCAAATCCAGATATC -> ACTTCAAATCCAGATATCA
GACTTTCGGTTACTGGATG -> ACTTTCGGTTACTGGATGT
GACTTTCTAGGGGTCCAAT -> ACTTTCTAGGGGTCCAATA
GACTTTTCGGGAATCGTTG -> ACTTTTCGGGAATCGTTGC
GAGACTCATGGATGACCTA -> AGACTCATGGATGACCTAA
GAGAGGCTAGTGTATTTCA -> AGAGGCTAGTGTATTTCAT
GAGAGTGTTCCACAAGCGT -> AGAGTGTTCCACAAGCGTA
GAGAGTTTGAGTCCATCCC -> AGAGTTTGAGTCCATCCCA
GAGATCGAGCTACTTCATA -> AGATCGAGCTACTTCATAG
GAGCAATAGTTTCGATGCT -> AGCAATAGTTTCGATGCTA
GAGCCACCGTTTGCTTTCC -> AGCCACCGTTTGCTTTCCT
GAGCCTCTCGACTTTCGGT -> AGCCTCTCGACTTTCGGTT
GAGCGTCCGGAACAATGCC -> AGCGTCCGGAACAATGCCC
GAGCTACTTCATAGACCAC -> AGCTACTTCATAGACCACA
GAGCTCAGGGTTCATTCCT -> AGCTCAGGGTTCATTCCTT
GAGCTTCACAGAGTCCGGC -> AGCTTCACAGAGTCCGGCT
GAGCTTTCTTTCTAGGCGC -> AGCTTTCTTTCTAGGCGCT
GAGGACTAGACAGTGATTA -> AGGACTAGACAGTGATTAG
GAGGCTAGTGTATTTCATG -> AGGCTAGTGTATTTCATGT
GAGGGACCAACGGTAATCA -> AGGGACCAACGGTAATCAA
GAGGGGGCACTCACGTATC -> AGGGGGCACTCACGTATCC
GAGGGTTTATCGATAGGAG -> AGGGTTTATCGATAGGAGT
GAGGGTTTTTTTCCCCTTT -> AGGGTTTTTTTCCCCTTTG
GAGGTCAGTCCCCATGCTG -> AGGTCAGTCCCCATGCTGT
GAGTAAGGAATTCCACTGG -> AGTAAGGAATTCCACTGGT
GAGTATGTGATCCCTGGAT -> AGTATGTGATCCCTGGATG
GAGTCCATCCCAGTTGAGG -> AGTCCATCCCAGTTGAGGT
GAGTCCGGCTGAATTGCGA -> AGTCCGGCTGAATTGCGAT
GAGTCGACTAAAATTGAAG -> AGTCGACTAAAATTGAAGC
GAGTGTATCGGGATGTGCA -> AGTGTATCGGGATGTGCAA
GAGTGTTCCACAAGCGTAT -> AGTGTTCCACAAGCGTATG
GAGTTATACTCTCTGGTAA -> AGTTATACTCTCTGGTAAT
GAGTTTAGACGAACAGCTA -> AGTTTAGACGAACAGCTAT
GAGTTTGAGTCCATCCCAG -> AGTTTGAGTCCATCCCAGT
GATACAACTGACCATACGG -> ATACAACTGACCATACGGC
GATACACCTAAGTTTCGTT -> ATACACCTAAGTTTCGTTC
GATAGACTTTTCGGGAATC -> ATAGACTTTTCGGGAATCG
GATAGGAGTTATACTCTCT -> ATAGGAGTTATACTCTCTG
GATATCACCAGTCGCCCGT -> ATATCACCAGTCGCCCGTA
GATATGTACCAGGCATTGG -> ATATGTACCAGGCATTGGG
GATCAGTTAGTTAGGCAAA -> ATCAGTTAGTTAGGCAAAG
GATCAGTTCGTTATCTTCG -> ATCAGTTCGTTATCTTCGG
GATCAGTTGCACATCTCAG -> ATCAGTTGCACATCTCAGG
GATCAGTTTGTGGAACATA -> ATCAGTTTGTGGAACATAG
GATCCAAGAAAAGCACGAG -> ATCCAAGAAAAGCACGAGT
GATCCCTGGATGTGTGATC -> ATCCCTGGATGTGTGATCA
GATCGAGCTACTTCATAGA -> ATCGAGCTACTTCATAGAC
GATCGCGAGTGTATCGGGA -> ATCGCGAGTGTATCGGGAT
GATCTTGTGGCAGCCGTCT -> ATCTTGTGGCAGCCGTCTG
GATGACCTAACGCGCTGTT -> ATGACCTAACGCGCTGTTT
GATGCCATAGCGTACCCTG -> ATGCCATAGCGTACCCTGG
GATGCTATCGGTCATCCAG -> ATGCTATCGGTCATCCAGT
GATGGCCGCGATCCAAGAA -> ATGGCCGCGATCCAAGAAA
GATGGTCTTGTTAGAATAA -> ATGGTCTTGTTAGAATAAT
GATGTGCAAAACTGCACGT -> ATGTGCAAAACTGCACGTT
GATGTGTGATCAGTTAGTT -> ATGTGTGATCAGTTAGTTA
GATGTGTGATCAGTTCGTT -> ATGTGTGATCAGTTCGTTA
GATGTGTGATCAGTTGCAC -> ATGTGTGATCAGTTGCACA
GATGTGTGATCAGTTTGTG -> ATGTGTGATCAGTTTGTGG
GATTAAATCCACGATTAGT -> ATTAAATCCACGATTAGTG
GATTAAGCAGCCACACAAG -> ATTAAGCAGCCACACAAGA
GATTAATGCGAACTTCCAG -> ATTAATGCGAACTTCCAGT
GATTACGTCTTGTGAAACA -> ATTACGTCTTGTGAAACAT
GATTACGTGGGAGCAATAG -> ATTACGTGGGAGCAATAGT
GATTAGATTACGTGGGAGC -> ATTAGATTACGTGGGAGCA
GATTAGTGGCACGGAATCA -> ATTAGTGGCACGGAATCAC
GATTATCTTTGTGCGTGTT -> ATTATCTTTGTGCGTGTTT
GATTCAGCGTGATTATCTT -> ATTCAGCGTGATTATCTTT
GATTGGCTCTAGCCGGGCA -> ATTGGCTCTAGCCGGGCAG
GATTGGGTGACTTTCTAGG -> ATTGGGTGACTTTCTAGGG
GATTTACTCCCCTTTGTAA -> ATTTACTCCCCTTTGTAAG
GCAAAACTGCACGTTTGCT -> CAAAACTGCACGTTTGCTG
GCAAAGTGCCATACCCTTC -> CAAAGTGCCATACCCTTCT
GCAAATCCCGTGCTTGACC -> CAAATCCCGTGCTTGACCA
GCAAGATACAACTGACCAT -> CAAGATACAACTGACCATA
GCAAGGTGGGCGGCCTAGA -> CAAGGTGGGCGGCCTAGAG
GCAAGTGTTGTGGCGGCTT -> CAAGTGTTGTGGCGGCTTT
GCAATAGTTTCGATGCTAT -> CAATAGTTTCGATGCTATC
GCACACCTACACTCGCGAT -> CACACCTACACTCGCGATG
GCACATCTCAGGTGCCATA -> CACATCTCAGGTGCCATAC
GCACCGACGGAGCTTCACA -> CACCGACGGAGCTTCACAG
GCACGAGTATGTGATCCCT -> CACGAGTATGTGATCCCTG
GCACGGAAAAAGTTCTGGA -> CACGGAAAAAGTTCTGGAA
GCACGGAATCACAATACCT -> CACGGAATCACAATACCTA
GCACGTTTGCTGGGCCGGC -> CACGTTTGCTGGGCCGGCT
GCACTCACGTATCCGTATG -> CACTCACGTATCCGTATGC
GCAGAACTGGAAATAGACT -> CAGAACTGGAAATAGACTC
GCAGAATAGCGATAGACTT -> CAGAATAGCGATAGACTTT
GCAGAGCCTCTCGACTTTC -> CAGAGCCTCTCGACTTTCG
GCAGCCACACAAGAAAGTT -> CAGCCACACAAGAAAGTTG
GCAGCCGTCTGGATGTGTG -> CAGCCGTCTGGATGTGTGA
GCAGTCCTACAGAGGACTA -> CAGTCCTACAGAGGACTAG
GCATAATAGGACCCGTGGG -> CATAATAGGACCCGTGGGA
GCATCACTATCGACCGGAT -> CATCACTATCGACCGGATT
GCATTGGGGAATGGCGAGG -> CATTGGGGAATGGCGAGGG
GCCAACCATAATAGGAGCC -> CCAACCATAATAGGAGCCA
GCCAACGATGGCCGCGATC -> CCAACGATGGCCGCGATCC
GCCAATCGTCTTTCATGTC -> CCAATCGTCTTTCATGTCG
GCCACACAAGAAAGTTGGG -> CCACACAAGAAAGTTGGGG
GCCACAGTGGGCAAGGTGG -> CCACAGTGGGCAAGGTGGG
GCCACCGTTTGCTTTCCTT -> CCACCGTTTGCTTTCCTTA
GCCACTTAGCGAACGGGAG -> CCACTTAGCGAACGGGAGT
GCCAGACAGTCGCTCGACG -> CCAGACAGTCGCTCGACGT
GCCAGCCTGAGGGTTTTTT -> CCAGCCTGAGGGTTTTTTT
GCCAGGCATAATAGGACCC -> CCAGGCATAATAGGACCCG
GCCATAAGGACCTCGCGCA -> CCATAAGGACCTCGCGCAG
GCCATACCCTTCTGCCAAT -> CCATACCCTTCTGCCAATC
GCCATACCCTTCTGCCAGC -> CCATACCCTTCTGCCAGCC
GCCATACCCTTCTGCCATA -> CCATACCCTTCTGCCATAA,CCATACCCTTCTGCCATAT
GCCATAGCGTACCCTGGGA -> CCATAGCGTACCCTGGGAA
GCCATATAAGTCAGGGGCA -> CCATATAAGTCAGGGGCAC
GCCCAATAAAGGATTACGT -> CCCAATAAAGGATTACGTC
GCCCGCAGTCCTACAGAGG -> CCCGCAGTCCTACAGAGGA
GCCCGTAACGGACTGGTGT -> CCCGTAACGGACTGGTGTG
GCCCGTCAACAACCTCTTA -> CCCGTCAACAACCTCTTAT
GCCCGTGAGCTTTCTTTCT -> CCCGTGAGCTTTCTTTCTA
GCCGCGATCCAAGAAAAGC -> CCGCGATCCAAGAAAAGCA
GCCGCGGGCGTCCAGCGCG -> CCGCGGGCGTCCAGCGCGT
GCCGGCTCCATGACTTCAA -> CCGGCTCCATGACTTCAAA
GCCGGGCAGAACTGGAAAT -> CCGGGCAGAACTGGAAATA
GCCGGGCCTTTACATGAGG -> CCGGGCCTTTACATGAGGG
GCCGGGTTATTATCTATCT -> CCGGGTTATTATCTATCTC
GCCGTCTGGATGTGTGATC -> CCGTCTGGATGTGTGATCA
GCCTACTACAGAATCCTGA -> CCTACTACAGAATCCTGAA
GCCTACTCATGGCCAACCA -> CCTACTCATGGCCAACCAT
GCCTAGAGAGTGTTCCACA -> CCTAGAGAGTGTTCCACAA
GCCTAGCATCACTATCGAC -> CCTAGCATCACTATCGACC
GCCTCAGGCGGAGAGTTTG -> CCTCAGGCGGAGAGTTTGA
GCCTCCCTGCCTACTACAG -> CCTCCCTGCCTACTACAGA
GCCTCGGGACATGTCGGGA -> CCTCGGGACATGTCGGGAA
GCCTCTCGACTTTCGGTTA -> CCTCTCGACTTTCGGTTAC
GCCTGAGGGTTTTTTTCCC -> CCTGAGGGTTTTTTTCCCC
GCCTGCTTCACTATCGTCC -> CCTGCTTCACTATCGTCCT
GCCTGGTCACCCTACAACC -> CCTGGTCACCCTACAACCT
GCCTTTACATGAGGGACCA -> CCTTTACATGAGGGACCAA
GCGAACCGGTTAATCGTGC -> CGAACCGGTTAATCGTGCT
GCGAACGGGAGTCGACTAA -> CGAACGGGAGTCGACTAAA
GCGAACTTCCAGTCATGCT -> CGAACTTCCAGTCATGCTA
GCGAATCGTCCAACATCTT -> CGAATCGTCCAACATCTTA
GCGAGGGTTTATCGATAGG -> CGAGGGTTTATCGATAGGA
GCGAGTAAGGAATTCCACT -> CGAGTAAGGAATTCCACTG
GCGAGTGTATCGGGATGTG -> CGAGTGTATCGGGATGTGC
GCGATAGACTTTTCGGGAA -> CGATAGACTTTTCGGGAAT
GCGATCCAAGAAAAGCACG -> CGATCCAAGAAAAGCACGA
GCGATCGCGAGTGTATCGG -> CGATCGCGAGTGTATCGGG
GCGATGCCATAGCGTACCC -> CGATGCCATAGCGTACCCT
GCGCAGAATAGCGATAGAC -> CGCAGAATAGCGATAGACT
GCGCGAATCGTCCAACATC -> CGCGAATCGTCCAACATCT
GCGCGTCTTATACGTCGTC -> CGCGTCTTATACGTCGTCG
GCGCTGGATGTGTGATCAG -> CGCTGGATGTGTGATCAGT
GCGCTGTTTAATGTCCACA -> CGCTGTTTAATGTCCACAG
GCGGAGAGTTTGAGTCCAT -> CGGAGAGTTTGAGTCCATC
GCGGCCTAGAGAGTGTTCC -> CGGCCTAGAGAGTGTTCCA
GCGGCTTTAACTACAATTA -> CGGCTTTAACTACAATTAA
GCGGGCGTCCAGCGCGTCT -> CGGGCGTCCAGCGCGTCTT
GCGGGTCCCGGAACCAGCC -> CGGGTCCCGGAACCAGCCT
GCGGTTGCCTGCTTCACTA -> CGGTTGCCTGCTTCACTAT
GCGTACCCTGGGAATGTAG -> CGTACCCTGGGAATGTAGC
GCGTATATATGCCTAGCAT -> CGTATATATGCCTAGCATC
GCGTATGCCAACGATGGCC -> CGTATGCCAACGATGGCCG
GCGTCCAGCGCGTCTTATA -> CGTCCAGCGCGTCTTATAC
GCGTCCGGAACAATGCCCG -> CGTCCGGAACAATGCCCGT
GCGTCGACGCGTATATATG -> CGTCGACGCGTATATATGC
GCGTCTTATACGTCGTCGG -> CGTCTTATACGTCGTCGGA
GCGTGATTATCTTTGTGCG -> CGTGATTATCTTTGTGCGT
GCGTGGGCTCAACTATCAG -> CGTGGGCTCAACTATCAGA
GCGTGTTTTCGTACTGTAG -> CGTGTTTTCGTACTGTAGC
GCGTTGCACACCTACACTC -> CGTTGCACACCTACACTCG
GCTACGATTGGCTCTAGCC -> CTACGATTGGCTCTAGCCG
GCTACTTCATAGACCACAG -> CTACTTCATAGACCACAGA
GCTAGTCAGCTGCTGCTGG -> CTAGTCAGCTGCTGCTGGG
GCTAGTGTATTTCATGTGG -> CTAGTGTATTTCATGTGGT
GCTATCGGTCATCCAGTTG -> CTATCGGTCATCCAGTTGG
GCTATGTCTCGTTGGACGC -> CTATGTCTCGTTGGACGCG
GCTCAACTATCAGACATGA -> CTCAACTATCAGACATGAT
GCTCAGGGTTCATTCCTTG -> CTCAGGGTTCATTCCTTGT
GCTCCATGACTTCAAATCC -> CTCCATGACTTCAAATCCA
GCTCGAATCTCAAAGCGTT -> CTCGAATCTCAAAGCGTTG
GCTCGACGTGAATAAGGAT -> CTCGACGTGAATAAGGATC
GCTCTAGCCGGGCAGAACT -> CTCTAGCCGGGCAGAACTG
GCTCTGGCCACTTAGCGAA -> CTCTGGCCACTTAGCGAAC
GCTGAATTGCGATCGCGAG -> CTGAATTGCGATCGCGAGT
GCTGCTGCTGGGCCCGCAG -> CTGCTGCTGGGCCCGCAGT
GCTGCTGGGCCCGCAGTCC -> CTGCTGGGCCCGCAGTCCT
GCTGGATGTGTGATCAGTT -> CTGGATGTGTGATCAGTTG
GCTGGGCCCGCAGTCCTAC -> CTGGGCCCGCAGTCCTACA
GCTGGGCCGGCTCCATGAC -> CTGGGCCGGCTCCATGACT
GCTGTATGTACAATCTTGG -> CTGTATGTACAATCTTGGC
GCTGTGTTGGGTAACAGAG -> CTGTGTTGGGTAACAGAGC
GCTGTTTAATGTCCACAGT -> CTGTTTAATGTCCACAGTT
GCTTCACAGAGTCCGGCTG -> CTTCACAGAGTCCGGCTGA
GCTTCACTATCGTCCTGTC -> CTTCACTATCGTCCTGTCG
GCTTGACCACAAACGAATA -> CTTGACCACAAACGAATAG
GCTTTAACTACAATTAAGC -> CTTTAACTACAATTAAGCA
GCTTTCCTTAATACCATAG -> CTTTCCTTAATACCATAGA
GCTTTCTTTCTAGGCGCTG -> CTTTCTTTCTAGGCGCTGG
GGAAAAAGTTCTGGAAGCC -> GAAAAAGTTCTGGAAGCCG
GGAAAGCTCTGGCCACTTA -> GAAAGCTCTGGCCACTTAG
GGAAATAGACTCCAGGAAA -> GAAATAGACTCCAGGAAAG
GGAACAATGCCCGTCAACA -> GAACAATGCCCGTCAACAA
GGAACATAGTGCCATACCC -> GAACATAGTGCCATACCCT
GGAACCAGCCTCAGGCGGA -> GAACCAGCCTCAGGCGGAG
GGAACCTTGAACACGTTGA -> GAACCTTGAACACGTTGAG
GGAAGATTTACTCCCCTTT -> GAAGATTTACTCCCCTTTG
GGAAGCCGGGTTATTATCT -> GAAGCCGGGTTATTATCTA
GGAATACGACTGCAAATCC -> GAATACGACTGCAAATCCC
GGAATCACAATACCTAGGA -> GAATCACAATACCTAGGAT
GGAATCGTTGCCTCCCTGC -> GAATCGTTGCCTCCCTGCC
GGAATGGCGAGGGTTTATC -> GAATGGCGAGGGTTTATCG
GGAATGTAGCAAGATACAA -> GAATGTAGCAAGATACAAC
GGAATTCCACTGGTCCTGC -> GAATTCCACTGGTCCTGCG
GGACATGTCGGGAATACGA -> GACATGTCGGGAATACGAC
GGACCAACGGTAATCAAGA -> GACCAACGGTAATCAAGAC
GGACCCGTGGGAGATCGAG -> GACCCGTGGGAGATCGAGC
GGACCTCGCGCAGAATAGC -> GACCTCGCGCAGAATAGCG
GGACGATTCAGCGTGATTA -> GACGATTCAGCGTGATTAT
GGACGCGTGGGCTCAACTA -> GACGCGTGGGCTCAACTAT
GGACGGCCTGGTCACCCTA -> GACGGCCTGGTCACCCTAC
GGACTAGACAGTGATTAGA -> GACTAGACAGTGATTAGAT
GGACTGGTGTGGCAGAGCC -> GACTGGTGTGGCAGAGCCT
GGAGAGTTTGAGTCCATCC -> GAGAGTTTGAGTCCATCCC
GGAGATCGAGCTACTTCAT -> GAGATCGAGCTACTTCATA
GGAGCAATAGTTTCGATGC -> GAGCAATAGTTTCGATGCT
GGAGCCACCGTTTGCTTTC -> GAGCCACCGTTTGCTTTCC
GGAGCTTCACAGAGTCCGG -> GAGCTTCACAGAGTCCGGC
GGAGTCGACTAAAATTGAA -> GAGTCGACTAAAATTGAAG
GGAGTTATACTCTCTGGTA -> GAGTTATACTCTCTGGTAA
GGATACACCTAAGTTTCGT -> GATACACCTAAGTTTCGTT
GGATCTTGTGGCAGCCGTC -> GATCTTGTGGCAGCCGTCT
GGATGACCTAACGCGCTGT -> GATGACCTAACGCGCTGTT
GGATGTGCAAAACTGCACG -> GATGTGCAAAACTGCACGT
GGATGTGTGATCAGTTAGT -> GATGTGTGATCAGTTAGTT
GGATGTGTGATCAGTTCGT -> GATGTGTGATCAGTTCGTT
GGATGTGTGATCAGTTGCA -> GATGTGTGATCAGTTGCAC
GGATGTGTGATCAGTTTGT -> GATGTGTGATCAGTTTGTG
GGATTAAATCCACGATTAG -> GATTAAATCCACGATTAGT
GGATTAATGCGAACTTCCA -> GATTAATGCGAACTTCCAG
GGATTACGTCTTGTGAAAC -> GATTACGTCTTGTGAAACA
GGCAAAGTGCCATACCCTT -> GCAAAGTGCCATACCCTTC
GGCAAGGTGGGCGGCCTAG -> GCAAGGTGGGCGGCCTAGA
GGCAAGTGTTGTGGCGGCT -> GCAAGTGTTGTGGCGGCTT
GGCACGGAAAAAGTTCTGG -> GCACGGAAAAAGTTCTGGA
GGCACGGAATCACAATACC -> GCACGGAATCACAATACCT
GGCACTCACGTATCCGTAT -> GCACTCACGTATCCGTATG
GGCAGAACTGGAAATAGAC -> GCAGAACTGGAAATAGACT
GGCAGAGCCTCTCGACTTT -> GCAGAGCCTCTCGACTTTC
GGCAGCCGTCTGGATGTGT -> GCAGCCGTCTGGATGTGTG
GGCATAATAGGACCCGTGG -> GCATAATAGGACCCGTGGG
GGCATTGGGGAATGGCGAG -> GCATTGGGGAATGGCGAGG
GGCCAACCATAATAGGAGC -> GCCAACCATAATAGGAGCC
GGCCACTTAGCGAACGGGA -> GCCACTTAGCGAACGGGAG
GGCCAGACAGTCGCTCGAC -> GCCAGACAGTCGCTCGACG
GGCCCGCAGTCCTACAGAG -> GCCCGCAGTCCTACAGAGG
GGCCGCGATCCAAGAAAAG -> GCCGCGATCCAAGAAAAGC
GGCCGCGGGCGTCCAGCGC -> GCCGCGGGCGTCCAGCGCG
GGCCGGCTCCATGACTTCA -> GCCGGCTCCATGACTTCAA
GGCCTAGAGAGTGTTCCAC -> GCCTAGAGAGTGTTCCACA
GGCCTGGTCACCCTACAAC -> GCCTGGTCACCCTACAACC
GGCCTTTACATGAGGGACC -> GCCTTTACATGAGGGACCA
GGCGAGGGTTTATCGATAG -> GCGAGGGTTTATCGATAGG
GGCGAGTAAGGAATTCCAC -> GCGAGTAAGGAATTCCACT
GGCGCTGGATGTGTGATCA -> GCGCTGGATGTGTGATCAG
GGCGGAGAGTTTGAGTCCA -> GCGGAGAGTTTGAGTCCAT
GGCGGCCTAGAGAGTGTTC -> GCGGCCTAGAGAGTGTTCC
GGCGGCTTTAACTACAATT -> GCGGCTTTAACTACAATTA
GGCGGGTCCCGGAACCAGC -> GCGGGTCCCGGAACCAGCC
GGCGTCCAGCGCGTCTTAT -> GCGTCCAGCGCGTCTTATA
GGCGTCGACGCGTATATAT -> GCGTCGACGCGTATATATG
GGCTAGTCAGCTGCTGCTG -> GCTAGTCAGCTGCTGCTGG
GGCTAGTGTATTTCATGTG -> GCTAGTGTATTTCATGTGG
GGCTCAACTATCAGACATG -> GCTCAACTATCAGACATGA
GGCTCCATGACTTCAAATC -> GCTCCATGACTTCAAATCC
GGCTCTAGCCGGGCAGAAC -> GCTCTAGCCGGGCAGAACT
GGCTGAATTGCGATCGCGA -> GCTGAATTGCGATCGCGAG
GGCTTTAACTACAATTAAG -> GCTTTAACTACAATTAAGC
GGGAACCTTGAACACGTTG -> GGAACCTTGAACACGTTGA
GGGAATACGACTGCAAATC -> GGAATACGACTGCAAATCC
GGGAATCGTTGCCTCCCTG -> GGAATCGTTGCCTCCCTGC
GGGAATGGCGAGGGTTTAT -> GGAATGGCGAGGGTTTATC
GGGAATGTAGCAAGATACA -> GGAATGTAGCAAGATACAA
GGGACATGTCGGGAATACG -> GGACATGTCGGGAATACGA
GGGACCAACGGTAATCAAG -> GGACCAACGGTAATCAAGA
GGGACGGCCTGGTCACCCT -> GGACGGCCTGGTCACCCTA
GGGAGATCGAGCTACTTCA -> GGAGATCGAGCTACTTCAT
GGGAGCAATAGTTTCGATG -> GGAGCAATAGTTTCGATGC
GGGAGTCGACTAAAATTGA -> GGAGTCGACTAAAATTGAA
GGGATGTGCAAAACTGCAC -> GGATGTGCAAAACTGCACG
GGGCAAGGTGGGCGGCCTA -> GGCAAGGTGGGCGGCCTAG
GGGCACGGAAAAAGTTCTG -> GGCACGGAAAAAGTTCTGG
GGGCACTCACGTATCCGTA -> GGCACTCACGTATCCGTAT
GGGCAGAACTGGAAATAGA -> GGCAGAACTGGAAATAGAC
GGGCCCGCAGTCCTACAGA -> GGCCCGCAGTCCTACAGAG
GGGCCGCGGGCGTCCAGCG -> GGCCGCGGGCGTCCAGCGC
GGGCCGGCTCCATGACTTC -> GGCCGGCTCCATGACTTCA
GGGCCTTTACATGAGGGAC -> GGCCTTTACATGAGGGACC
GGGCGGCCTAGAGAGTGTT -> GGCGGCCTAGAGAGTGTTC
GGGCGTCCAGCGCGTCTTA -> GGCGTCCAGCGCGTCTTAT
GGGCTCAACTATCAGACAT -> GGCTCAACTATCAGACATG
GGGGAATGGCGAGGGTTTA -> GGGAATGGCGAGGGTTTAT
GGGGACGGCCTGGTCACCC -> GGGACGGCCTGGTCACCCT
GGGGCACGGAAAAAGTTCT -> GGGCACGGAAAAAGTTCTG
GGGGCACTCACGTATCCGT -> GGGCACTCACGTATCCGTA
GGGGGACGGCCTGGTCACC -> GGGGACGGCCTGGTCACCC
GGGGGCACTCACGTATCCG -> GGGGCACTCACGTATCCGT
GGGGGGGTGGCGAGTAAGG -> GGGGGGTGGCGAGTAAGGA
GGGGGGTGGCGAGTAAGGA -> GGGGGTGGCGAGTAAGGAA
GGGGGTGGCGAGTAAGGAA -> GGGGTGGCGAGTAAGGAAT
GGGGTCCAATAGCCCGTGA -> GGGTCCAATAGCCCGTGAG
GGGGTGGCGAGTAAGGAAT -> GGGTGGCGAGTAAGGAATT
GGGTAACAGAGCTCAGGGT -> GGTAACAGAGCTCAGGGTT
GGGTCCAATAGCCCGTGAG -> GGTCCAATAGCCCGTGAGC
GGGTCCCGGAACCAGCCTC -> GGTCCCGGAACCAGCCTCA
GGGTGACTTTCTAGGGGTC -> GGTGACTTTCTAGGGGTCC
GGGTGGCGAGTAAGGAATT -> GGTGGCGAGTAAGGAATTC
GGGTTATTATCTATCTCGA -> GGTTATTATCTATCTCGAG
GGGTTCATTCCTTGTACCT -> GGTTCATTCCTTGTACCTG
GGGTTTATCGATAGGAGTT -> GGTTTATCGATAGGAGTTA
GGGTTTTTTTCCCCTTTGA -> GGTTTTTTTCCCCTTTGAA
GGTAACAGAGCTCAGGGTT -> GTAACAGAGCTCAGGGTTC
GGTAATCAAGACACGAGCG -> GTAATCAAGACACGAGCGT
GGTAATCACAGCTACGATT -> GTAATCACAGCTACGATTG
GGTCAATAAGGTGTTGTCA -> GTCAATAAGGTGTTGTCAG
GGTCACCCTACAACCTCGC -> GTCACCCTACAACCTCGCC
GGTCAGTCCCCATGCTGTG -> GTCAGTCCCCATGCTGTGT
GGTCATCCAGTTGGAAGAT -> GTCATCCAGTTGGAAGATT
GGTCCAATAGCCCGTGAGC -> GTCCAATAGCCCGTGAGCT
GGTCCCGGAACCAGCCTCA -> GTCCCGGAACCAGCCTCAG
GGTCCTGCGGTTGCCTGCT -> GTCCTGCGGTTGCCTGCTT
GGTCTTGTTAGAATAATAC -> GTCTTGTTAGAATAATACG
GGTGACTTTCTAGGGGTCC -> GTGACTTTCTAGGGGTCCA
GGTGCCATACCCTTCTGCC -> GTGCCATACCCTTCTGCCA,GTGCCATACCCTTCTGCCA
GGTGCGAACCGGTTAATCG -> GTGCGAACCGGTTAATCGT
GGTGGCGAGTAAGGAATTC -> GTGGCGAGTAAGGAATTCC
GGTGGGCGGCCTAGAGAGT -> GTGGGCGGCCTAGAGAGTG
GGTGTGGCAGAGCCTCTCG -> GTGTGGCAGAGCCTCTCGA
GGTGTTGTCAGTGTCGATG -> GTGTTGTCAGTGTCGATGG
GGTTAATCGTGCTGTATGT -> GTTAATCGTGCTGTATGTA
GGTTACTGGATGTGTGATC -> GTTACTGGATGTGTGATCA
GGTTATTATCTATCTCGAG -> GTTATTATCTATCTCGAGG
GGTTCATTCCTTGTACCTG -> GTTCATTCCTTGTACCTGT
GGTTGCCTGCTTCACTATC -> GTTGCCTGCTTCACTATCG
GGTTTAGACCGTACCGGCA -> GTTTAGACCGTACCGGCAA
GGTTTATCGATAGGAGTTA -> GTTTATCGATAGGAGTTAT
GGTTTTTTTCCCCTTTGAA -> GTTTTTTTCCCCTTTGAAC
GTAACAGAGCTCAGGGTTC -> TAACAGAGCTCAGGGTTCA
GTAACGGACTGGTGTGGCA -> TAACGGACTGGTGTGGCAG
GTAAGGAATTCCACTGGTC -> TAAGGAATTCCACTGGTCC
GTAAGTCGGGGGACGGCCT -> TAAGTCGGGGGACGGCCTG
GTAATCAAGACACGAGCGT -> TAATCAAGACACGAGCGTC
GTAATCACAGCTACGATTG -> TAATCACAGCTACGATTGG
GTACAATCTTGGCGGGTCC -> TACAATCTTGGCGGGTCCC
GTACCAGGCATTGGGGAAT -> TACCAGGCATTGGGGAATG
GTACCCTGGGAATGTAGCA -> TACCCTGGGAATGTAGCAA
GTACCGGCAAGTGTTGTGG -> TACCGGCAAGTGTTGTGGC
GTACCTGTAGTTACCAAAG -> TACCTGTAGTTACCAAAGC
GTACTGTAGCCTCGGGACA -> TACTGTAGCCTCGGGACAT
GTAGAGACTCATGGATGAC -> TAGAGACTCATGGATGACC
GTAGAGTTTAGACGAACAG -> TAGAGTTTAGACGAACAGC
GTAGCAAGATACAACTGAC -> TAGCAAGATACAACTGACC
GTAGCCTCGGGACATGTCG -> TAGCCTCGGGACATGTCGG
GTAGTTACCAAAGCCTACT -> TAGTTACCAAAGCCTACTC
GTATATATGCCTAGCATCA -> TATATATGCCTAGCATCAC
GTATCCGTATGCCCAATAA -> TATCCGTATGCCCAATAAA
GTATCGGGATGTGCAAAAC -> TATCGGGATGTGCAAAACT
GTATGCCAACGATGGCCGC -> TATGCCAACGATGGCCGCG
GTATGCCCAATAAAGGATT -> TATGCCCAATAAAGGATTA
GTATGTACAATCTTGGCGG -> TATGTACAATCTTGGCGGG
GTATGTGATCCCTGGATGT -> TATGTGATCCCTGGATGTG
GTATTCAGCCACAGTGGGC -> TATTCAGCCACAGTGGGCA
GTATTTCATGTGGTGCGAA -> TATTTCATGTGGTGCGAAC
GTCAACAACCTCTTATTGA -> TCAACAACCTCTTATTGAC
GTCAATAAGGTGTTGTCAG -> TCAATAAGGTGTTGTCAGT
GTCACCCTACAACCTCGCC -> TCACCCTACAACCTCGCCA
GTCAGCTGCTGCTGGGCCC -> TCAGCTGCTGCTGGGCCCG
GTCAGGGGCACGGAAAAAG -> TCAGGGGCACGGAAAAAGT
GTCAGTCCCCATGCTGTGT -> TCAGTCCCCATGCTGTGTT
GTCAGTGTCGATGGTCTTG -> TCAGTGTCGATGGTCTTGT
GTCATCCAGTTGGAAGATT -> TCATCCAGTTGGAAGATTT
GTCCAACATCTTAACAGCC -> TCCAACATCTTAACAGCCG
GTCCAATAGCCCGTGAGCT -> TCCAATAGCCCGTGAGCTT
GTCCACAGTTATCACTTGT -> TCCACAGTTATCACTTGTA
GTCCAGCGCGTCTTATACG -> TCCAGCGCGTCTTATACGT
GTCCATCCCAGTTGAGGTC -> TCCATCCCAGTTGAGGTCA
GTCCCCATGCTGTGTTGGG -> TCCCCATGCTGTGTTGGGT
GTCCCGGAACCAGCCTCAG -> TCCCGGAACCAGCCTCAGG
GTCCGCTCGAATCTCAAAG -> TCCGCTCGAATCTCAAAGC
GTCCGGAACAATGCCCGTC -> TCCGGAACAATGCCCGTCA
GTCCGGCTGAATTGCGATC -> TCCGGCTGAATTGCGATCG
GTCCTACAGAGGACTAGAC -> TCCTACAGAGGACTAGACA
GTCCTGCGGTTGCCTGCTT -> TCCTGCGGTTGCCTGCTTC
GTCCTGTCGGCCAGACAGT -> TCCTGTCGGCCAGACAGTC
GTCGACGCGTATATATGCC -> TCGACGCGTATATATGCCT
GTCGACTAAAATTGAAGCG -> TCGACTAAAATTGAAGCGC
GTCGATGGTCTTGTTAGAA -> TCGATGGTCTTGTTAGAAT
GTCGATTAAGCAGCCACAC -> TCGATTAAGCAGCCACACA
GTCGCCCGTAACGGACTGG -> TCGCCCGTAACGGACTGGT
GTCGCTCGACGTGAATAAG -> TCGCTCGACGTGAATAAGG
GTCGGATTAAATCCACGAT -> TCGGATTAAATCCACGATT
GTCGGCCAGACAGTCGCTC -> TCGGCCAGACAGTCGCTCG
GTCGGGAATACGACTGCAA -> TCGGGAATACGACTGCAAA
GTCGGGGGACGGCCTGGTC -> TCGGGGGACGGCCTGGTCA
GTCGTCGGATTAAATCCAC -> TCGTCGGATTAAATCCACG
GTCTCGTTGGACGCGTGGG -> TCTCGTTGGACGCGTGGGC
GTCTGGATGTGTGATCAGT -> TCTGGATGTGTGATCAGTT
GTCTTATACGTCGTCGGAT -> TCTTATACGTCGTCGGATT
GTCTTGTGAAACATCAGAA -> TCTTGTGAAACATCAGAAC
GTCTTGTTAGAATAATACG -> TCTTGTTAGAATAATACGG
GTCTTTCATGTCGATTAAG -> TCTTTCATGTCGATTAAGC
GTGAAACATCAGAACACCG -> TGAAACATCAGAACACCGT
GTGAATAAGGATCTTGTGG -> TGAATAAGGATCTTGTGGC
GTGACCAATAATCCCAACC -> TGACCAATAATCCCAACCT
GTGACTTTCTAGGGGTCCA -> TGACTTTCTAGGGGTCCAA
GTGAGCTTTCTTTCTAGGC -> TGAGCTTTCTTTCTAGGCG
GTGATCAGTTAGTTAGGCA -> TGATCAGTTAGTTAGGCAA
GTGATCAGTTCGTTATCTT -> TGATCAGTTCGTTATCTTC
GTGATCAGTTGCACATCTC -> TGATCAGTTGCACATCTCA
GTGATCAGTTTGTGGAACA -> TGATCAGTTTGTGGAACAT
GTGATCCCTGGATGTGTGA -> TGATCCCTGGATGTGTGAT
GTGATTAGATTACGTGGGA -> TGATTAGATTACGTGGGAG
GTGATTATCTTTGTGCGTG -> TGATTATCTTTGTGCGTGT
GTGCAAAACTGCACGTTTG -> TGCAAAACTGCACGTTTGC
GTGCCATACCCTTCTGCCA -> TGCCATACCCTTCTGCCAA,TGCCATACCCTTCTGCCAG,TGCCATACCCTTCTGCCAT,TGCCATACCCTTCTGCCAT
GTGCGAACCGGTTAATCGT -> TGCGAACCGGTTAATCGTG
GTGCGTGTTTTCGTACTGT -> TGCGTGTTTTCGTACTGTA
GTGCTGTATGTACAATCTT -> TGCTGTATGTACAATCTTG
GTGCTTGACCACAAACGAA -> TGCTTGACCACAAACGAAT
GTGGAACATAGTGCCATAC -> TGGAACATAGTGCCATACC
GTGGCACGGAATCACAATA -> TGGCACGGAATCACAATAC
GTGGCAGAGCCTCTCGACT -> TGGCAGAGCCTCTCGACTT
GTGGCAGCCGTCTGGATGT -> TGGCAGCCGTCTGGATGTG
GTGGCGAGTAAGGAATTCC -> TGGCGAGTAAGGAATTCCA
GTGGCGGCTTTAACTACAA -> TGGCGGCTTTAACTACAAT
GTGGGAGATCGAGCTACTT -> TGGGAGATCGAGCTACTTC
GTGGGAGCAATAGTTTCGA -> TGGGAGCAATAGTTTCGAT
GTGGGCAAGGTGGGCGGCC -> TGGGCAAGGTGGGCGGCCT
GTGGGCGGCCTAGAGAGTG -> TGGGCGGCCTAGAGAGTGT
GTGGGCTCAACTATCAGAC -> TGGGCTCAACTATCAGACA
GTGGTGCGAACCGGTTAAT -> TGGTGCGAACCGGTTAATC
GTGTAGAGTTTAGACGAAC -> TGTAGAGTTTAGACGAACA
GTGTATCGGGATGTGCAAA -> TGTATCGGGATGTGCAAAA
GTGTATTTCATGTGGTGCG -> TGTATTTCATGTGGTGCGA
GTGTCGATGGTCTTGTTAG -> TGTCGATGGTCTTGTTAGA
GTGTGATCAGTTAGTTAGG -> TGTGATCAGTTAGTTAGGC
GTGTGATCAGTTCGTTATC -> TGTGATCAGTTCGTTATCT
GTGTGATCAGTTGCACATC -> TGTGATCAGTTGCACATCT
GTGTGATCAGTTTGTGGAA -> TGTGATCAGTTTGTGGAAC
GTGTGGCAGAGCCTCTCGA -> TGTGGCAGAGCCTCTCGAC
GTGTTCCACAAGCGTATGC -> TGTTCCACAAGCGTATGCC
GTGTTGGGTAACAGAGCTC -> TGTTGGGTAACAGAGCTCA
GTGTTGTCAGTGTCGATGG -> TGTTGTCAGTGTCGATGGT
GTGTTGTGGCGGCTTTAAC -> TGTTGTGGCGGCTTTAACT
GTGTTTTCGTACTGTAGCC -> TGTTTTCGTACTGTAGCCT
GTTAATCGTGCTGTATGTA -> TTAATCGTGCTGTATGTAC
GTTACCAAAGCCTACTCAT -> TTACCAAAGCCTACTCATG
GTTACTGGATGTGTGATCA -> TTACTGGATGTGTGATCAG
GTTAGAATAATACGGGAAC -> TTAGAATAATACGGGAACC
GTTAGGCAAAGTGCCATAC -> TTAGGCAAAGTGCCATACC
GTTAGTTAGGCAAAGTGCC -> TTAGTTAGGCAAAGTGCCA
GTTATACTCTCTGGTAATC -> TTATACTCTCTGGTAATCA
GTTATCACTTGTATTCAGC -> TTATCACTTGTATTCAGCC
GTTATCTTCGGTGCCATAC -> TTATCTTCGGTGCCATACC
GTTATTATCTATCTCGAGG -> TTATTATCTATCTCGAGGG
GTTCAAGTGACCAATAATC -> TTCAAGTGACCAATAATCC
GTTCATTCCTTGTACCTGT -> TTCATTCCTTGTACCTGTA
GTTCCACAAGCGTATGCCA -> TTCCACAAGCGTATGCCAA
GTTCGTTATCTTCGGTGCC -> TTCGTTATCTTCGGTGCCA
GTTCTGGAAGCCGGGTTAT -> TTCTGGAAGCCGGGTTATT
GTTGAGAGGCTAGTGTATT -> TTGAGAGGCTAGTGTATTT
GTTGAGGTCAGTCCCCATG -> TTGAGGTCAGTCCCCATGC
GTTGATTGGGTGACTTTCT -> TTGATTGGGTGACTTTCTA
GTTGCACACCTACACTCGC -> TTGCACACCTACACTCGCG
GTTGCACATCTCAGGTGCC -> TTGCACATCTCAGGTGCCA
GTTGCCTCCCTGCCTACTA -> TTGCCTCCCTGCCTACTAC
GTTGCCTGCTTCACTATCG -> TTGCCTGCTTCACTATCGT
GTTGGAAGATTTACTCCCC -> TTGGAAGATTTACTCCCCT
GTTGGACGCGTGGGCTCAA -> TTGGACGCGTGGGCTCAAC
GTTGGGCCGCGGGCGTCCA -> TTGGGCCGCGGGCGTCCAG
GTTGGGGGGGTGGCGAGTA -> TTGGGGGGGTGGCGAGTAA
GTTGGGTAACAGAGCTCAG -> TTGGGTAACAGAGCTCAGG
GTTGTCAGTGTCGATGGTC -> TTGTCAGTGTCGATGGTCT
GTTGTGGCGGCTTTAACTA -> TTGTGGCGGCTTTAACTAC
GTTTAATGTCCACAGTTAT -> TTTAATGTCCACAGTTATC
GTTTAGACCGTACCGGCAA -> TTTAGACCGTACCGGCAAG
GTTTAGACGAACAGCTATG -> TTTAGACGAACAGCTATGT
GTTTATCGATAGGAGTTAT -> TTTATCGATAGGAGTTATA
GTTTCGATGCTATCGGTCA -> TTTCGATGCTATCGGTCAT
GTTTCGTTCAAGTGACCAA -> TTTCGTTCAAGTGACCAAT
GTTTGAGTCCATCCCAGTT -> TTTGAGTCCATCCCAGTTG
GTTTGCTGGGCCGGCTCCA -> TTTGCTGGGCCGGCTCCAT
GTTTGCTTTCCTTAATACC -> TTTGCTTTCCTTAATACCA
GTTTGTGGAACATAGTGCC -> TTTGTGGAACATAGTGCCA
GTTTTCGTACTGTAGCCTC -> TTTTCGTACTGTAGCCTCG
GTTTTTTTCCCCTTTGAAC -> TTTTTTTCCCCTTTGAACA
TAAAATTGAAGCGCGAATC -> AAAATTGAAGCGCGAATCG
TAAAGGATTACGTCTTGTG -> AAAGGATTACGTCTTGTGA
TAAATCCACGATTAGTGGC -> AAATCCACGATTAGTGGCA
TAACAGAGCTCAGGGTTCA -> AACAGAGCTCAGGGTTCAT
TAACAGCCGGGCCTTTACA -> AACAGCCGGGCCTTTACAT
TAACGCGCTGTTTAATGTC -> AACGCGCTGTTTAATGTCC
TAACGGACTGGTGTGGCAG -> AACGGACTGGTGTGGCAGA
TAACTACAATTAAGCACCG -> AACTACAATTAAGCACCGA
TAAGCACCGACGGAGCTTC -> AAGCACCGACGGAGCTTCA
TAAGCAGCCACACAAGAAA -> AAGCAGCCACACAAGAAAG
TAAGGAATTCCACTGGTCC -> AAGGAATTCCACTGGTCCT
TAAGGACCTCGCGCAGAAT -> AAGGACCTCGCGCAGAATA
TAAGGATCTTGTGGCAGCC -> AAGGATCTTGTGGCAGCCG
TAAGGTGTTGTCAGTGTCG -> AAGGTGTTGTCAGTGTCGA
TAAGTCAGGGGCACGGAAA -> AAGTCAGGGGCACGGAAAA
TAAGTCGGGGGACGGCCTG -> AAGTCGGGGGACGGCCTGG
TAAGTTTCGTTCAAGTGAC -> AAGTTTCGTTCAAGTGACC
TAATACCATAGAAGTTGAT -> AATACCATAGAAGTTGATT
TAATACGGGAACCTTGAAC -> AATACGGGAACCTTGAACA
TAATAGGACCCGTGGGAGA -> AATAGGACCCGTGGGAGAT
TAATAGGAGCCACCGTTTG -> AATAGGAGCCACCGTTTGC
TAATCAAGACACGAGCGTC -> AATCAAGACACGAGCGTCC
TAATCACAGCTACGATTGG -> AATCACAGCTACGATTGGC
TAATCCCAACCTTCGAACG -> AATCCCAACCTTCGAACGT
TAATCGTGCTGTATGTACA -> AATCGTGCTGTATGTACAA
TAATGCGAACTTCCAGTCA -> AATGCGAACTTCCAGTCAT
TAATGTCCACAGTTATCAC -> AATGTCCACAGTTATCACT
TACAACCTCGCCAGGCATA -> ACAACCTCGCCAGGCATAA
TACAACTGACCATACGGCG -> ACAACTGACCATACGGCGT
TACAATCTTGGCGGGTCCC -> ACAATCTTGGCGGGTCCCG
TACAATTAAGCACCGACGG -> ACAATTAAGCACCGACGGA
TACACCTAAGTTTCGTTCA -> ACACCTAAGTTTCGTTCAA
TACACTCGCGATGCCATAG -> ACACTCGCGATGCCATAGC
TACAGAATCCTGAAACGGA -> ACAGAATCCTGAAACGGAC
TACAGAGGACTAGACAGTG -> ACAGAGGACTAGACAGTGA
TACATGAGGGACCAACGGT -> ACATGAGGGACCAACGGTA
TACCAAAGCCTACTCATGG -> ACCAAAGCCTACTCATGGC
TACCAGGCATTGGGGAATG -> ACCAGGCATTGGGGAATGG
TACCATAGAAGTTGATTGG -> ACCATAGAAGTTGATTGGG
TACCCTGGGAATGTAGCAA -> ACCCTGGGAATGTAGCAAG
TACCCTTCTGCCAATCGTC -> ACCCTTCTGCCAATCGTCT
TACCCTTCTGCCAGCCTGA -> ACCCTTCTGCCAGCCTGAG
TACCCTTCTGCCATAAGGA -> ACCCTTCTGCCATAAGGAC
TACCCTTCTGCCATATAAG -> ACCCTTCTGCCATATAAGT
TACCGGCAAGTGTTGTGGC -> ACCGGCAAGTGTTGTGGCG
TACCTAGGATACACCTAAG -> ACCTAGGATACACCTAAGT
TACCTGTAGTTACCAAAGC -> ACCTGTAGTTACCAAAGCC
TACGACTGCAAATCCCGTG -> ACGACTGCAAATCCCGTGC
TACGATTGGCTCTAGCCGG -> ACGATTGGCTCTAGCCGGG
TACGGCGTCGACGCGTATA -> ACGGCGTCGACGCGTATAT
TACGGGAACCTTGAACACG -> ACGGGAACCTTGAACACGT
TACGTCGTCGGATTAAATC -> ACGTCGTCGGATTAAATCC
TACGTCTTGTGAAACATCA -> ACGTCTTGTGAAACATCAG
TACGTGGGAGCAATAGTTT -> ACGTGGGAGCAATAGTTTC
TACTACAGAATCCTGAAAC -> ACTACAGAATCCTGAAACG
TACTCATGGCCAACCATAA -> ACTCATGGCCAACCATAAT
TACTCCCCTTTGTAAGTCG -> ACTCCCCTTTGTAAGTCGG
TACTCTCTGGTAATCACAG -> ACTCTCTGGTAATCACAGC
TACTGGATGTGTGATCAGT -> ACTGGATGTGTGATCAGTT
TACTGTAGCCTCGGGACAT -> ACTGTAGCCTCGGGACATG
TACTTCATAGACCACAGAC -> ACTTCATAGACCACAGACT
TAGAAGTTGATTGGGTGAC -> AGAAGTTGATTGGGTGACT
TAGAATAATACGGGAACCT -> AGAATAATACGGGAACCTT
TAGACAGTGATTAGATTAC -> AGACAGTGATTAGATTACG
TAGACCACAGACTCCGTAG -> AGACCACAGACTCCGTAGA
TAGACCGTACCGGCAAGTG -> AGACCGTACCGGCAAGTGT
TAGACGAACAGCTATGTCT -> AGACGAACAGCTATGTCTC
TAGACTCCAGGAAAGCTCT -> AGACTCCAGGAAAGCTCTG
TAGACTTTTCGGGAATCGT -> AGACTTTTCGGGAATCGTT
TAGAGACTCATGGATGACC -> AGAGACTCATGGATGACCT
TAGAGAGTGTTCCACAAGC -> AGAGAGTGTTCCACAAGCG
TAGAGTTTAGACGAACAGC -> AGAGTTTAGACGAACAGCT
TAGATTACGTGGGAGCAAT -> AGATTACGTGGGAGCAATA
TAGCAAGATACAACTGACC -> AGCAAGATACAACTGACCA
TAGCATCACTATCGACCGG -> AGCATCACTATCGACCGGA
TAGCCCGTGAGCTTTCTTT -> AGCCCGTGAGCTTTCTTTC
TAGCCGGGCAGAACTGGAA -> AGCCGGGCAGAACTGGAAA
TAGCCTCGGGACATGTCGG -> AGCCTCGGGACATGTCGGG
TAGCGAACGGGAGTCGACT -> AGCGAACGGGAGTCGACTA
TAGCGATAGACTTTTCGGG -> AGCGATAGACTTTTCGGGA
TAGCGTACCCTGGGAATGT -> AGCGTACCCTGGGAATGTA
TAGGACCCGTGGGAGATCG -> AGGACCCGTGGGAGATCGA
TAGGAGCCACCGTTTGCTT -> AGGAGCCACCGTTTGCTTT
TAGGAGTTATACTCTCTGG -> AGGAGTTATACTCTCTGGT
TAGGATACACCTAAGTTTC -> AGGATACACCTAAGTTTCG
TAGGCAAAGTGCCATACCC -> AGGCAAAGTGCCATACCCT
TAGGCGCTGGATGTGTGAT -> AGGCGCTGGATGTGTGATC
TAGGGGTCCAATAGCCCGT -> AGGGGTCCAATAGCCCGTG
TAGTCAGCTGCTGCTGGGC -> AGTCAGCTGCTGCTGGGCC
TAGTGCCATACCCTTCTGC -> AGTGCCATACCCTTCTGCC
TAGTGGCACGGAATCACAA -> AGTGGCACGGAATCACAAT
TAGTGTATTTCATGTGGTG -> AGTGTATTTCATGTGGTGC
TAGTTACCAAAGCCTACTC -> AGTTACCAAAGCCTACTCA
TAGTTAGGCAAAGTGCCAT -> AGTTAGGCAAAGTGCCATA
TAGTTGGGCCGCGGGCGTC -> AGTTGGGCCGCGGGCGTCC
TAGTTTCGATGCTATCGGT -> AGTTTCGATGCTATCGGTC
TATAAGTCAGGGGCACGGA -> ATAAGTCAGGGGCACGGAA
TATACGTCGTCGGATTAAA -> ATACGTCGTCGGATTAAAT
TATACTCTCTGGTAATCAC -> ATACTCTCTGGTAATCACA
TATATATGCCTAGCATCAC -> ATATATGCCTAGCATCACT
TATATGCCTAGCATCACTA -> ATATGCCTAGCATCACTAT
TATCACCAGTCGCCCGTAA -> ATCACCAGTCGCCCGTAAC
TATCACTTGTATTCAGCCA -> ATCACTTGTATTCAGCCAC
TATCAGACATGATATGTAC -> ATCAGACATGATATGTACC
TATCCGTATGCCCAATAAA -> ATCCGTATGCCCAATAAAG
TATCGACCGGATTAATGCG -> ATCGACCGGATTAATGCGA
TATCGATAGGAGTTATACT -> ATCGATAGGAGTTATACTC
TATCGGGATGTGCAAAACT -> ATCGGGATGTGCAAAACTG
TATCGGTCATCCAGTTGGA -> ATCGGTCATCCAGTTGGAA
TATCGTCCTGTCGGCCAGA -> ATCGTCCTGTCGGCCAGAC
TATCTATCTCGAGGGGGCA -> ATCTATCTCGAGGGGGCAC
TATCTCGAGGGGGCACTCA -> ATCTCGAGGGGGCACTCAC
TATCTTCGGTGCCATACCC -> ATCTTCGGTGCCATACCCT
TATCTTTGTGCGTGTTTTC -> ATCTTTGTGCGTGTTTTCG
TATGCCAACGATGGCCGCG -> ATGCCAACGATGGCCGCGA
TATGCCCAATAAAGGATTA -> ATGCCCAATAAAGGATTAC
TATGCCTAGCATCACTATC -> ATGCCTAGCATCACTATCG
TATGTACAATCTTGGCGGG -> ATGTACAATCTTGGCGGGT
TATGTACCAGGCATTGGGG -> ATGTACCAGGCATTGGGGA
TATGTCTCGTTGGACGCGT -> ATGTCTCGTTGGACGCGTG
TATGTGATCCCTGGATGTG -> ATGTGATCCCTGGATGTGT
TATTATCTATCTCGAGGGG -> ATTATCTATCTCGAGGGGG
TATTCAGCCACAGTGGGCA -> ATTCAGCCACAGTGGGCAA
TATTGACAGGCTAGTCAGC -> ATTGACAGGCTAGTCAGCT
TATTTCATGTGGTGCGAAC -> ATTTCATGTGGTGCGAACC
TCAAAGCGTTGCACACCTA -> CAAAGCGTTGCACACCTAC
TCAAATCCAGATATCACCA -> CAAATCCAGATATCACCAG
TCAACAACCTCTTATTGAC -> CAACAACCTCTTATTGACA
TCAACTATCAGACATGATA -> CAACTATCAGACATGATAT
TCAAGACACGAGCGTCCGG -> CAAGACACGAGCGTCCGGA
TCAAGTGACCAATAATCCC -> CAAGTGACCAATAATCCCA
TCAATAAGGTGTTGTCAGT -> CAATAAGGTGTTGTCAGTG
TCACAATACCTAGGATACA -> CACAATACCTAGGATACAC
TCACAGAGTCCGGCTGAAT -> CACAGAGTCCGGCTGAATT
TCACAGCTACGATTGGCTC -> CACAGCTACGATTGGCTCT
TCACCAGTCGCCCGTAACG -> CACCAGTCGCCCGTAACGG
TCACCCTACAACCTCGCCA -> CACCCTACAACCTCGCCAG
TCACGTATCCGTATGCCCA -> CACGTATCCGTATGCCCAA
TCACTATCGACCGGATTAA -> CACTATCGACCGGATTAAT
TCACTATCGTCCTGTCGGC -> CACTATCGTCCTGTCGGCC
TCACTTGTATTCAGCCACA -> CACTTGTATTCAGCCACAG
TCAGAACACCGTCCGCTCG -> CAGAACACCGTCCGCTCGA
TCAGACATGATATGTACCA -> CAGACATGATATGTACCAG
TCAGCCACAGTGGGCAAGG -> CAGCCACAGTGGGCAAGGT
TCAGCGTGATTATCTTTGT -> CAGCGTGATTATCTTTGTG
TCAGCTGCTGCTGGGCCCG -> CAGCTGCTGCTGGGCCCGC
TCAGGCGGAGAGTTTGAGT -> CAGGCGGAGAGTTTGAGTC
TCAGGGGCACGGAAAAAGT -> CAGGGGCACGGAAAAAGTT
TCAGGGTTCATTCCTTGTA -> CAGGGTTCATTCCTTGTAC
TCAGGTGCCATACCCTTCT -> CAGGTGCCATACCCTTCTG
TCAGTCCCCATGCTGTGTT -> CAGTCCCCATGCTGTGTTG
TCAGTGTCGATGGTCTTGT -> CAGTGTCGATGGTCTTGTT
TCAGTTAGTTAGGCAAAGT -> CAGTTAGTTAGGCAAAGTG
TCAGTTCGTTATCTTCGGT -> CAGTTCGTTATCTTCGGTG
TCAGTTGCACATCTCAGGT -> CAGTTGCACATCTCAGGTG
TCAGTTTGTGGAACATAGT -> CAGTTTGTGGAACATAGTG
TCATAGACCACAGACTCCG -> CATAGACCACAGACTCCGT
TCATCCAGTTGGAAGATTT -> CATCCAGTTGGAAGATTTA
TCATGGATGACCTAACGCG -> CATGGATGACCTAACGCGC
TCATGGCCAACCATAATAG -> CATGGCCAACCATAATAGG
TCATGTCGATTAAGCAGCC -> CATGTCGATTAAGCAGCCA
TCATGTGGTGCGAACCGGT -> CATGTGGTGCGAACCGGTT
TCATTCCTTGTACCTGTAG -> CATTCCTTGTACCTGTAGT
TCCAACATCTTAACAGCCG -> CCAACATCTTAACAGCCGG
TCCAAGAAAAGCACGAGTA -> CCAAGAAAAGCACGAGTAT
TCCAATAGCCCGTGAGCTT -> CCAATAGCCCGTGAGCTTT
TCCACAAGCGTATGCCAAC -> CCACAAGCGTATGCCAACG
TCCACAGTTATCACTTGTA -> CCACAGTTATCACTTGTAT
TCCACGATTAGTGGCACGG -> CCACGATTAGTGGCACGGA
TCCACTGGTCCTGCGGTTG -> CCACTGGTCCTGCGGTTGC
TCCAGATATCACCAGTCGC -> CCAGATATCACCAGTCGCC
TCCAGCGCGTCTTATACGT -> CCAGCGCGTCTTATACGTC
TCCAGGAAAGCTCTGGCCA -> CCAGGAAAGCTCTGGCCAC
TCCAGTTGGAAGATTTACT -> CCAGTTGGAAGATTTACTC
TCCATCCCAGTTGAGGTCA -> CCATCCCAGTTGAGGTCAG
TCCATGACTTCAAATCCAG -> CCATGACTTCAAATCCAGA
TCCCAACCTTCGAACGTGT -> CCCAACCTTCGAACGTGTA
TCCCAGTTGAGGTCAGTCC -> CCCAGTTGAGGTCAGTCCC
TCCCCATGCTGTGTTGGGT -> CCCCATGCTGTGTTGGGTA
TCCCCTTTGAACACGGTCA -> CCCCTTTGAACACGGTCAA
TCCCCTTTGTAAGTCGGGG -> CCCCTTTGTAAGTCGGGGG
TCCCGGAACCAGCCTCAGG -> CCCGGAACCAGCCTCAGGC
TCCCGTGCTTGACCACAAA -> CCCGTGCTTGACCACAAAC
TCCCTGCCTACTACAGAAT -> CCCTGCCTACTACAGAATC
TCCCTGGATGTGTGATCAG -> CCCTGGATGTGTGATCAGT
TCCGCTCGAATCTCAAAGC -> CCGCTCGAATCTCAAAGCG
TCCGGAACAATGCCCGTCA -> CCGGAACAATGCCCGTCAA
TCCGGCTGAATTGCGATCG -> CCGGCTGAATTGCGATCGC
TCCGTAGAGACTCATGGAT -> CCGTAGAGACTCATGGATG
TCCGTATGCCCAATAAAGG -> CCGTATGCCCAATAAAGGA
TCCTACAGAGGACTAGACA -> CCTACAGAGGACTAGACAG
TCCTGAAACGGACGATTCA -> CCTGAAACGGACGATTCAG
TCCTGCGGTTGCCTGCTTC -> CCTGCGGTTGCCTGCTTCA
TCCTGTCGGCCAGACAGTC -> CCTGTCGGCCAGACAGTCG
TCCTTAATACCATAGAAGT -> CCTTAATACCATAGAAGTT
TCCTTGTACCTGTAGTTAC -> CCTTGTACCTGTAGTTACC
TCGAACGTGTAGAGTTTAG -> CGAACGTGTAGAGTTTAGA
TCGAATCTCAAAGCGTTGC -> CGAATCTCAAAGCGTTGCA
TCGACCGGATTAATGCGAA -> CGACCGGATTAATGCGAAC
TCGACGCGTATATATGCCT -> CGACGCGTATATATGCCTA
TCGACGTGAATAAGGATCT -> CGACGTGAATAAGGATCTT
TCGACTAAAATTGAAGCGC -> CGACTAAAATTGAAGCGCG
TCGACTTTCGGTTACTGGA -> CGACTTTCGGTTACTGGAT
TCGAGCTACTTCATAGACC -> CGAGCTACTTCATAGACCA
TCGAGGGGGCACTCACGTA -> CGAGGGGGCACTCACGTAT
TCGATAGGAGTTATACTCT -> CGATAGGAGTTATACTCTC
TCGATGCTATCGGTCATCC -> CGATGCTATCGGTCATCCA
TCGATGGTCTTGTTAGAAT -> CGATGGTCTTGTTAGAATA
TCGATTAAGCAGCCACACA -> CGATTAAGCAGCCACACAA
TCGCCAGGCATAATAGGAC -> CGCCAGGCATAATAGGACC
TCGCCCGTAACGGACTGGT -> CGCCCGTAACGGACTGGTG
TCGCGAGTGTATCGGGATG -> CGCGAGTGTATCGGGATGT
TCGCGATGCCATAGCGTAC -> CGCGATGCCATAGCGTACC
TCGCGCAGAATAGCGATAG -> CGCGCAGAATAGCGATAGA
TCGCTCGACGTGAATAAGG -> CGCTCGACGTGAATAAGGA
TCGGATTAAATCCACGATT -> CGGATTAAATCCACGATTA
TCGGCCAGACAGTCGCTCG -> CGGCCAGACAGTCGCTCGA
TCGGGAATACGACTGCAAA -> CGGGAATACGACTGCAAAT
TCGGGAATCGTTGCCTCCC -> CGGGAATCGTTGCCTCCCT
TCGGGACATGTCGGGAATA -> CGGGACATGTCGGGAATAC
TCGGGATGTGCAAAACTGC -> CGGGATGTGCAAAACTGCA
TCGGGGGACGGCCTGGTCA -> CGGGGGACGGCCTGGTCAC
TCGGTCATCCAGTTGGAAG -> CGGTCATCCAGTTGGAAGA
TCGGTGCCATACCCTTCTG -> CGGTGCCATACCCTTCTGC
TCGGTTACTGGATGTGTGA -> CGGTTACTGGATGTGTGAT
TCGTACTGTAGCCTCGGGA -> CGTACTGTAGCCTCGGGAC
TCGTCCAACATCTTAACAG -> CGTCCAACATCTTAACAGC
TCGTCCTGTCGGCCAGACA -> CGTCCTGTCGGCCAGACAG
TCGTCGGATTAAATCCACG -> CGTCGGATTAAATCCACGA
TCGTCTTTCATGTCGATTA -> CGTCTTTCATGTCGATTAA
TCGTGCTGTATGTACAATC -> CGTGCTGTATGTACAATCT
TCGTTATCTTCGGTGCCAT -> CGTTATCTTCGGTGCCATA
TCGTTCAAGTGACCAATAA -> CGTTCAAGTGACCAATAAT
TCGTTGCCTCCCTGCCTAC -> CGTTGCCTCCCTGCCTACT
TCGTTGGACGCGTGGGCTC -> CGTTGGACGCGTGGGCTCA
TCTAGCCGGGCAGAACTGG -> CTAGCCGGGCAGAACTGGA
TCTAGGCGCTGGATGTGTG -> CTAGGCGCTGGATGTGTGA
TCTAGGGGTCCAATAGCCC -> CTAGGGGTCCAATAGCCCG
TCTATCTCGAGGGGGCACT -> CTATCTCGAGGGGGCACTC
TCTCAAAGCGTTGCACACC -> CTCAAAGCGTTGCACACCT
TCTCAGGTGCCATACCCTT -> CTCAGGTGCCATACCCTTC
TCTCGACTTTCGGTTACTG -> CTCGACTTTCGGTTACTGG
TCTCGAGGGGGCACTCACG -> CTCGAGGGGGCACTCACGT
TCTCGTTGGACGCGTGGGC -> CTCGTTGGACGCGTGGGCT
TCTCTGGTAATCACAGCTA -> CTCTGGTAATCACAGCTAC
TCTGCCAATCGTCTTTCAT -> CTGCCAATCGTCTTTCATG
TCTGCCAGCCTGAGGGTTT -> CTGCCAGCCTGAGGGTTTT
TCTGCCATAAGGACCTCGC -> CTGCCATAAGGACCTCGCG
TCTGCCATATAAGTCAGGG -> CTGCCATATAAGTCAGGGG
TCTGGAAGCCGGGTTATTA -> CTGGAAGCCGGGTTATTAT
TCTGGATGTGTGATCAGTT -> CTGGATGTGTGATCAGTTT
TCTGGCCACTTAGCGAACG -> CTGGCCACTTAGCGAACGG
TCTGGTAATCACAGCTACG -> CTGGTAATCACAGCTACGA
TCTTAACAGCCGGGCCTTT -> CTTAACAGCCGGGCCTTTA
TCTTATACGTCGTCGGATT -> CTTATACGTCGTCGGATTA
TCTTATTGACAGGCTAGTC -> CTTATTGACAGGCTAGTCA
TCTTCGGTGCCATACCCTT -> CTTCGGTGCCATACCCTTC
TCTTGGCGGGTCCCGGAAC -> CTTGGCGGGTCCCGGAACC
TCTTGTGAAACATCAGAAC -> CTTGTGAAACATCAGAACA
TCTTGTGGCAGCCGTCTGG -> CTTGTGGCAGCCGTCTGGA
TCTTGTTAGAATAATACGG -> CTTGTTAGAATAATACGGG
TCTTTCATGTCGATTAAGC -> CTTTCATGTCGATTAAGCA
TCTTTCTAGGCGCTGGATG -> CTTTCTAGGCGCTGGATGT
TCTTTGTGCGTGTTTTCGT -> CTTTGTGCGTGTTTTCGTA
TGAAACATCAGAACACCGT -> GAAACATCAGAACACCGTC
TGAAACGGACGATTCAGCG -> GAAACGGACGATTCAGCGT
TGAACACGGTCAATAAGGT -> GAACACGGTCAATAAGGTG
TGAACACGTTGAGAGGCTA -> GAACACGTTGAGAGGCTAG
TGAAGCGCGAATCGTCCAA -> GAAGCGCGAATCGTCCAAC
TGAATAAGGATCTTGTGGC -> GAATAAGGATCTTGTGGCA
TGAATTGCGATCGCGAGTG -> GAATTGCGATCGCGAGTGT
TGACAGGCTAGTCAGCTGC -> GACAGGCTAGTCAGCTGCT
TGACCAATAATCCCAACCT -> GACCAATAATCCCAACCTT
TGACCACAAACGAATAGTT -> GACCACAAACGAATAGTTG
TGACCATACGGCGTCGACG -> GACCATACGGCGTCGACGC
TGACCTAACGCGCTGTTTA -> GACCTAACGCGCTGTTTAA
TGACTTCAAATCCAGATAT -> GACTTCAAATCCAGATATC
TGACTTTCTAGGGGTCCAA -> GACTTTCTAGGGGTCCAAT
TGAGAGGCTAGTGTATTTC -> GAGAGGCTAGTGTATTTCA
TGAGCTTTCTTTCTAGGCG -> GAGCTTTCTTTCTAGGCGC
TGAGGGACCAACGGTAATC -> GAGGGACCAACGGTAATCA
TGAGGGTTTTTTTCCCCTT -> GAGGGTTTTTTTCCCCTTT
TGAGGTCAGTCCCCATGCT -> GAGGTCAGTCCCCATGCTG
TGAGTCCATCCCAGTTGAG -> GAGTCCATCCCAGTTGAGG
TGATATGTACCAGGCATTG -> GATATGTACCAGGCATTGG
TGATCAGTTAGTTAGGCAA -> GATCAGTTAGTTAGGCAAA
TGATCAGTTCGTTATCTTC -> GATCAGTTCGTTATCTTCG
TGATCAGTTGCACATCTCA -> GATCAGTTGCACATCTCAG
TGATCAGTTTGTGGAACAT -> GATCAGTTTGTGGAACATA
TGATCCCTGGATGTGTGAT -> GATCCCTGGATGTGTGATC
TGATTAGATTACGTGGGAG -> GATTAGATTACGTGGGAGC
TGATTATCTTTGTGCGTGT -> GATTATCTTTGTGCGTGTT
TGATTGGGTGACTTTCTAG -> GATTGGGTGACTTTCTAGG
TGCAAAACTGCACGTTTGC -> GCAAAACTGCACGTTTGCT
TGCAAATCCCGTGCTTGAC -> GCAAATCCCGTGCTTGACC
TGCACACCTACACTCGCGA -> GCACACCTACACTCGCGAT
TGCACATCTCAGGTGCCAT -> GCACATCTCAGGTGCCATA
TGCACGTTTGCTGGGCCGG -> GCACGTTTGCTGGGCCGGC
TGCCAACGATGGCCGCGAT -> GCCAACGATGGCCGCGATC
TGCCAATCGTCTTTCATGT -> GCCAATCGTCTTTCATGTC
TGCCAGCCTGAGGGTTTTT -> GCCAGCCTGAGGGTTTTTT
TGCCATAAGGACCTCGCGC -> GCCATAAGGACCTCGCGCA
TGCCATACCCTTCTGCCAA -> GCCATACCCTTCTGCCAAT
TGCCATACCCTTCTGCCAG -> GCCATACCCTTCTGCCAGC
TGCCATACCCTTCTGCCAT -> GCCATACCCTTCTGCCATA,GCCATACCCTTCTGCCATA
TGCCATAGCGTACCCTGGG -> GCCATAGCGTACCCTGGGA
TGCCATATAAGTCAGGGGC -> GCCATATAAGTCAGGGGCA
TGCCCAATAAAGGATTACG -> GCCCAATAAAGGATTACGT
TGCCCGTCAACAACCTCTT -> GCCCGTCAACAACCTCTTA
TGCCTACTACAGAATCCTG -> GCCTACTACAGAATCCTGA
TGCCTAGCATCACTATCGA -> GCCTAGCATCACTATCGAC
TGCCTCCCTGCCTACTACA -> GCCTCCCTGCCTACTACAG
TGCCTGCTTCACTATCGTC -> GCCTGCTTCACTATCGTCC
TGCGAACCGGTTAATCGTG -> GCGAACCGGTTAATCGTGC
TGCGAACTTCCAGTCATGC -> GCGAACTTCCAGTCATGCT
TGCGATCGCGAGTGTATCG -> GCGATCGCGAGTGTATCGG
TGCGGTTGCCTGCTTCACT -> GCGGTTGCCTGCTTCACTA
TGCGTGTTTTCGTACTGTA -> GCGTGTTTTCGTACTGTAG
TGCTATCGGTCATCCAGTT -> GCTATCGGTCATCCAGTTG
TGCTGCTGGGCCCGCAGTC -> GCTGCTGGGCCCGCAGTCC
TGCTGGGCCCGCAGTCCTA -> GCTGGGCCCGCAGTCCTAC
TGCTGGGCCGGCTCCATGA -> GCTGGGCCGGCTCCATGAC
TGCTGTATGTACAATCTTG -> GCTGTATGTACAATCTTGG
TGCTGTGTTGGGTAACAGA -> GCTGTGTTGGGTAACAGAG
TGCTTCACTATCGTCCTGT -> GCTTCACTATCGTCCTGTC
TGCTTGACCACAAACGAAT -> GCTTGACCACAAACGAATA
TGCTTTCCTTAATACCATA -> GCTTTCCTTAATACCATAG
TGGAAATAGACTCCAGGAA -> GGAAATAGACTCCAGGAAA
TGGAACATAGTGCCATACC -> GGAACATAGTGCCATACCC
TGGAAGATTTACTCCCCTT -> GGAAGATTTACTCCCCTTT
TGGAAGCCGGGTTATTATC -> GGAAGCCGGGTTATTATCT
TGGACGCGTGGGCTCAACT -> GGACGCGTGGGCTCAACTA
TGGATGACCTAACGCGCTG -> GGATGACCTAACGCGCTGT
TGGATGTGTGATCAGTTAG -> GGATGTGTGATCAGTTAGT
TGGATGTGTGATCAGTTCG -> GGATGTGTGATCAGTTCGT
TGGATGTGTGATCAGTTGC -> GGATGTGTGATCAGTTGCA
TGGATGTGTGATCAGTTTG -> GGATGTGTGATCAGTTTGT
TGGCACGGAATCACAATAC -> GGCACGGAATCACAATACC
TGGCAGAGCCTCTCGACTT -> GGCAGAGCCTCTCGACTTT
TGGCAGCCGTCTGGATGTG -> GGCAGCCGTCTGGATGTGT
TGGCCAACCATAATAGGAG -> GGCCAACCATAATAGGAGC
TGGCCACTTAGCGAACGGG -> GGCCACTTAGCGAACGGGA
TGGCCGCGATCCAAGAAAA -> GGCCGCGATCCAAGAAAAG
TGGCGAGGGTTTATCGATA -> GGCGAGGGTTTATCGATAG
TGGCGAGTAAGGAATTCCA -> GGCGAGTAAGGAATTCCAC
TGGCGGCTTTAACTACAAT -> GGCGGCTTTAACTACAATT
TGGCGGGTCCCGGAACCAG -> GGCGGGTCCCGGAACCAGC
TGGCTCTAGCCGGGCAGAA -> GGCTCTAGCCGGGCAGAAC
TGGGAATGTAGCAAGATAC -> GGGAATGTAGCAAGATACA
TGGGAGATCGAGCTACTTC -> GGGAGATCGAGCTACTTCA
TGGGAGCAATAGTTTCGAT -> GGGAGCAATAGTTTCGATG
TGGGCAAGGTGGGCGGCCT -> GGGCAAGGTGGGCGGCCTA
TGGGCCCGCAGTCCTACAG -> GGGCCCGCAGTCCTACAGA
TGGGCCGCGGGCGTCCAGC -> GGGCCGCGGGCGTCCAGCG
TGGGCCGGCTCCATGACTT -> GGGCCGGCTCCATGACTTC
TGGGCGGCCTAGAGAGTGT -> GGGCGGCCTAGAGAGTGTT
TGGGCTCAACTATCAGACA -> GGGCTCAACTATCAGACAT
TGGGGAATGGCGAGGGTTT -> GGGGAATGGCGAGGGTTTA
TGGGGGGGTGGCGAGTAAG -> GGGGGGGTGGCGAGTAAGG
TGGGTAACAGAGCTCAGGG -> GGGTAACAGAGCTCAGGGT
TGGGTGACTTTCTAGGGGT -> GGGTGACTTTCTAGGGGTC
TGGTAATCACAGCTACGAT -> GGTAATCACAGCTACGATT
TGGTCACCCTACAACCTCG -> GGTCACCCTACAACCTCGC
TGGTCCTGCGGTTGCCTGC -> GGTCCTGCGGTTGCCTGCT
TGGTCTTGTTAGAATAATA -> GGTCTTGTTAGAATAATAC
TGGTGCGAACCGGTTAATC -> GGTGCGAACCGGTTAATCG
TGGTGTGGCAGAGCCTCTC -> GGTGTGGCAGAGCCTCTCG
TGGTTTAGACCGTACCGGC -> GGTTTAGACCGTACCGGCA
TGTAAGTCGGGGGACGGCC -> GTAAGTCGGGGGACGGCCT
TGTACAATCTTGGCGGGTC -> GTACAATCTTGGCGGGTCC
TGTACCAGGCATTGGGGAA -> GTACCAGGCATTGGGGAAT
TGTACCTGTAGTTACCAAA -> GTACCTGTAGTTACCAAAG
TGTAGAGTTTAGACGAACA -> GTAGAGTTTAGACGAACAG
TGTAGCAAGATACAACTGA -> GTAGCAAGATACAACTGAC
TGTAGCCTCGGGACATGTC -> GTAGCCTCGGGACATGTCG
TGTAGTTACCAAAGCCTAC -> GTAGTTACCAAAGCCTACT
TGTATCGGGATGTGCAAAA -> GTATCGGGATGTGCAAAAC
TGTATGTACAATCTTGGCG -> GTATGTACAATCTTGGCGG
TGTATTCAGCCACAGTGGG -> GTATTCAGCCACAGTGGGC
TGTATTTCATGTGGTGCGA -> GTATTTCATGTGGTGCGAA
TGTCAGTGTCGATGGTCTT -> GTCAGTGTCGATGGTCTTG
TGTCCACAGTTATCACTTG -> GTCCACAGTTATCACTTGT
TGTCGATGGTCTTGTTAGA -> GTCGATGGTCTTGTTAGAA
TGTCGATTAAGCAGCCACA -> GTCGATTAAGCAGCCACAC
TGTCGGCCAGACAGTCGCT -> GTCGGCCAGACAGTCGCTC
TGTCGGGAATACGACTGCA -> GTCGGGAATACGACTGCAA
TGTCTCGTTGGACGCGTGG -> GTCTCGTTGGACGCGTGGG
TGTGAAACATCAGAACACC -> GTGAAACATCAGAACACCG
TGTGATCAGTTAGTTAGGC -> GTGATCAGTTAGTTAGGCA
TGTGATCAGTTCGTTATCT -> GTGATCAGTTCGTTATCTT
TGTGATCAGTTGCACATCT -> GTGATCAGTTGCACATCTC
TGTGATCAGTTTGTGGAAC -> GTGATCAGTTTGTGGAACA
TGTGATCCCTGGATGTGTG -> GTGATCCCTGGATGTGTGA
TGTGCAAAACTGCACGTTT -> GTGCAAAACTGCACGTTTG
TGTGCGTGTTTTCGTACTG -> GTGCGTGTTTTCGTACTGT
TGTGGAACATAGTGCCATA -> GTGGAACATAGTGCCATAC
TGTGGCAGAGCCTCTCGAC -> GTGGCAGAGCCTCTCGACT
TGTGGCAGCCGTCTGGATG -> GTGGCAGCCGTCTGGATGT
TGTGGCGGCTTTAACTACA -> GTGGCGGCTTTAACTACAA
TGTGGTGCGAACCGGTTAA -> GTGGTGCGAACCGGTTAAT
TGTGTGATCAGTTAGTTAG -> GTGTGATCAGTTAGTTAGG
TGTGTGATCAGTTCGTTAT -> GTGTGATCAGTTCGTTATC
TGTGTGATCAGTTGCACAT -> GTGTGATCAGTTGCACATC
TGTGTGATCAGTTTGTGGA -> GTGTGATCAGTTTGTGGAA
TGTGTTGGGTAACAGAGCT -> GTGTTGGGTAACAGAGCTC
TGTTAGAATAATACGGGAA -> GTTAGAATAATACGGGAAC
TGTTCCACAAGCGTATGCC -> GTTCCACAAGCGTATGCCA
TGTTGGGTAACAGAGCTCA -> GTTGGGTAACAGAGCTCAG
TGTTGTCAGTGTCGATGGT -> GTTGTCAGTGTCGATGGTC
TGTTGTGGCGGCTTTAACT -> GTTGTGGCGGCTTTAACTA
TGTTTAATGTCCACAGTTA -> GTTTAATGTCCACAGTTAT
TGTTTTCGTACTGTAGCCT -> GTTTTCGTACTGTAGCCTC
TTAAATCCACGATTAGTGG -> TAAATCCACGATTAGTGGC
TTAACAGCCGGGCCTTTAC -> TAACAGCCGGGCCTTTACA
TTAACTACAATTAAGCACC -> TAACTACAATTAAGCACCG
TTAAGCACCGACGGAGCTT -> TAAGCACCGACGGAGCTTC
TTAAGCAGCCACACAAGAA -> TAAGCAGCCACACAAGAAA
TTAATACCATAGAAGTTGA -> TAATACCATAGAAGTTGAT
TTAATCGTGCTGTATGTAC -> TAATCGTGCTGTATGTACA
TTAATGCGAACTTCCAGTC -> TAATGCGAACTTCCAGTCA
TTAATGTCCACAGTTATCA -> TAATGTCCACAGTTATCAC
TTACATGAGGGACCAACGG -> TACATGAGGGACCAACGGT
TTACCAAAGCCTACTCATG -> TACCAAAGCCTACTCATGG
TTACGTCTTGTGAAACATC -> TACGTCTTGTGAAACATCA
TTACGTGGGAGCAATAGTT -> TACGTGGGAGCAATAGTTT
TTACTCCCCTTTGTAAGTC -> TACTCCCCTTTGTAAGTCG
TTACTGGATGTGTGATCAG -> TACTGGATGTGTGATCAGT
TTAGAATAATACGGGAACC -> TAGAATAATACGGGAACCT
TTAGACCGTACCGGCAAGT -> TAGACCGTACCGGCAAGTG
TTAGACGAACAGCTATGTC -> TAGACGAACAGCTATGTCT
TTAGATTACGTGGGAGCAA -> TAGATTACGTGGGAGCAAT
TTAGCGAACGGGAGTCGAC -> TAGCGAACGGGAGTCGACT
TTAGGCAAAGTGCCATACC -> TAGGCAAAGTGCCATACCC
TTAGTGGCACGGAATCACA -> TAGTGGCACGGAATCACAA
TTAGTTAGGCAAAGTGCCA -> TAGTTAGGCAAAGTGCCAT
TTATACGTCGTCGGATTAA -> TATACGTCGTCGGATTAAA
TTATACTCTCTGGTAATCA -> TATACTCTCTGGTAATCAC
TTATCACTTGTATTCAGCC -> TATCACTTGTATTCAGCCA
TTATCGATAGGAGTTATAC -> TATCGATAGGAGTTATACT
TTATCTATCTCGAGGGGGC -> TATCTATCTCGAGGGGGCA
TTATCTTCGGTGCCATACC -> TATCTTCGGTGCCATACCC
TTATCTTTGTGCGTGTTTT -> TATCTTTGTGCGTGTTTTC
TTATTATCTATCTCGAGGG -> TATTATCTATCTCGAGGGG
TTATTGACAGGCTAGTCAG -> TATTGACAGGCTAGTCAGC
TTCAAATCCAGATATCACC -> TCAAATCCAGATATCACCA
TTCAAGTGACCAATAATCC -> TCAAGTGACCAATAATCCC
TTCACAGAGTCCGGCTGAA -> TCACAGAGTCCGGCTGAAT
TTCACTATCGTCCTGTCGG -> TCACTATCGTCCTGTCGGC
TTCAGCCACAGTGGGCAAG -> TCAGCCACAGTGGGCAAGG
TTCAGCGTGATTATCTTTG -> TCAGCGTGATTATCTTTGT
TTCATAGACCACAGACTCC -> TCATAGACCACAGACTCCG
TTCATGTCGATTAAGCAGC -> TCATGTCGATTAAGCAGCC
TTCATGTGGTGCGAACCGG -> TCATGTGGTGCGAACCGGT
TTCATTCCTTGTACCTGTA -> TCATTCCTTGTACCTGTAG
TTCCACAAGCGTATGCCAA -> TCCACAAGCGTATGCCAAC
TTCCACTGGTCCTGCGGTT -> TCCACTGGTCCTGCGGTTG
TTCCCCTTTGAACACGGTC -> TCCCCTTTGAACACGGTCA
TTCCTTAATACCATAGAAG -> TCCTTAATACCATAGAAGT
TTCCTTGTACCTGTAGTTA -> TCCTTGTACCTGTAGTTAC
TTCGAACGTGTAGAGTTTA -> TCGAACGTGTAGAGTTTAG
TTCGATGCTATCGGTCATC -> TCGATGCTATCGGTCATCC
TTCGGGAATCGTTGCCTCC -> TCGGGAATCGTTGCCTCCC
TTCGGTGCCATACCCTTCT -> TCGGTGCCATACCCTTCTG
TTCGGTTACTGGATGTGTG -> TCGGTTACTGGATGTGTGA
TTCGTACTGTAGCCTCGGG -> TCGTACTGTAGCCTCGGGA
TTCGTTATCTTCGGTGCCA -> TCGTTATCTTCGGTGCCAT
TTCGTTCAAGTGACCAATA -> TCGTTCAAGTGACCAATAA
TTCTAGGCGCTGGATGTGT -> TCTAGGCGCTGGATGTGTG
TTCTAGGGGTCCAATAGCC -> TCTAGGGGTCCAATAGCCC
TTCTGCCAATCGTCTTTCA -> TCTGCCAATCGTCTTTCAT
TTCTGCCAGCCTGAGGGTT -> TCTGCCAGCCTGAGGGTTT
TTCTGCCATAAGGACCTCG -> TCTGCCATAAGGACCTCGC
TTCTGCCATATAAGTCAGG -> TCTGCCATATAAGTCAGGG
TTCTGGAAGCCGGGTTATT -> TCTGGAAGCCGGGTTATTA
TTCTTTCTAGGCGCTGGAT -> TCTTTCTAGGCGCTGGATG
TTGAACACGGTCAATAAGG -> TGAACACGGTCAATAAGGT
TTGAACACGTTGAGAGGCT -> TGAACACGTTGAGAGGCTA
TTGAAGCGCGAATCGTCCA -> TGAAGCGCGAATCGTCCAA
TTGACAGGCTAGTCAGCTG -> TGACAGGCTAGTCAGCTGC
TTGACCACAAACGAATAGT -> TGACCACAAACGAATAGTT
TTGAGAGGCTAGTGTATTT -> TGAGAGGCTAGTGTATTTC
TTGAGGTCAGTCCCCATGC -> TGAGGTCAGTCCCCATGCT
TTGAGTCCATCCCAGTTGA -> TGAGTCCATCCCAGTTGAG
TTGATTGGGTGACTTTCTA -> TGATTGGGTGACTTTCTAG
TTGCACACCTACACTCGCG -> TGCACACCTACACTCGCGA
TTGCACATCTCAGGTGCCA -> TGCACATCTCAGGTGCCAT
TTGCCTCCCTGCCTACTAC -> TGCCTCCCTGCCTACTACA
TTGCCTGCTTCACTATCGT -> TGCCTGCTTCACTATCGTC
TTGCGATCGCGAGTGTATC -> TGCGATCGCGAGTGTATCG
TTGCTGGGCCGGCTCCATG -> TGCTGGGCCGGCTCCATGA
TTGCTTTCCTTAATACCAT -> TGCTTTCCTTAATACCATA
TTGGAAGATTTACTCCCCT -> TGGAAGATTTACTCCCCTT
TTGGACGCGTGGGCTCAAC -> TGGACGCGTGGGCTCAACT
TTGGCGGGTCCCGGAACCA -> TGGCGGGTCCCGGAACCAG
TTGGCTCTAGCCGGGCAGA -> TGGCTCTAGCCGGGCAGAA
TTGGGCCGCGGGCGTCCAG -> TGGGCCGCGGGCGTCCAGC
TTGGGGAATGGCGAGGGTT -> TGGGGAATGGCGAGGGTTT
TTGGGGGGGTGGCGAGTAA -> TGGGGGGGTGGCGAGTAAG
TTGGGTAACAGAGCTCAGG -> TGGGTAACAGAGCTCAGGG
TTGGGTGACTTTCTAGGGG -> TGGGTGACTTTCTAGGGGT
TTGGTTTAGACCGTACCGG -> TGGTTTAGACCGTACCGGC
TTGTAAGTCGGGGGACGGC -> TGTAAGTCGGGGGACGGCC
TTGTACCTGTAGTTACCAA -> TGTACCTGTAGTTACCAAA
TTGTATTCAGCCACAGTGG -> TGTATTCAGCCACAGTGGG
TTGTCAGTGTCGATGGTCT -> TGTCAGTGTCGATGGTCTT
TTGTGAAACATCAGAACAC -> TGTGAAACATCAGAACACC
TTGTGCGTGTTTTCGTACT -> TGTGCGTGTTTTCGTACTG
TTGTGGAACATAGTGCCAT -> TGTGGAACATAGTGCCATA
TTGTGGCAGCCGTCTGGAT -> TGTGGCAGCCGTCTGGATG
TTGTGGCGGCTTTAACTAC -> TGTGGCGGCTTTAACTACA
TTGTTAGAATAATACGGGA -> TGTTAGAATAATACGGGAA
TTTAACTACAATTAAGCAC -> TTAACTACAATTAAGCACC
TTTAATGTCCACAGTTATC -> TTAATGTCCACAGTTATCA
TTTACATGAGGGACCAACG -> TTACATGAGGGACCAACGG
TTTACTCCCCTTTGTAAGT -> TTACTCCCCTTTGTAAGTC
TTTAGACCGTACCGGCAAG -> TTAGACCGTACCGGCAAGT
TTTAGACGAACAGCTATGT -> TTAGACGAACAGCTATGTC
TTTATCGATAGGAGTTATA -> TTATCGATAGGAGTTATAC
TTTCATGTCGATTAAGCAG -> TTCATGTCGATTAAGCAGC
TTTCATGTGGTGCGAACCG -> TTCATGTGGTGCGAACCGG
TTTCCCCTTTGAACACGGT -> TTCCCCTTTGAACACGGTC
TTTCCTTAATACCATAGAA -> TTCCTTAATACCATAGAAG
TTTCGATGCTATCGGTCAT -> TTCGATGCTATCGGTCATC
TTTCGGGAATCGTTGCCTC -> TTCGGGAATCGTTGCCTCC
TTTCGGTTACTGGATGTGT -> TTCGGTTACTGGATGTGTG
TTTCGTACTGTAGCCTCGG -> TTCGTACTGTAGCCTCGGG
TTTCGTTCAAGTGACCAAT -> TTCGTTCAAGTGACCAATA
TTTCTAGGCGCTGGATGTG -> TTCTAGGCGCTGGATGTGT
TTTCTAGGGGTCCAATAGC -> TTCTAGGGGTCCAATAGCC
TTTCTTTCTAGGCGCTGGA -> TTCTTTCTAGGCGCTGGAT
TTTGAACACGGTCAATAAG -> TTGAACACGGTCAATAAGG
TTTGAGTCCATCCCAGTTG -> TTGAGTCCATCCCAGTTGA
TTTGCTGGGCCGGCTCCAT -> TTGCTGGGCCGGCTCCATG
TTTGCTTTCCTTAATACCA -> TTGCTTTCCTTAATACCAT
TTTGTAAGTCGGGGGACGG -> TTGTAAGTCGGGGGACGGC
TTTGTGCGTGTTTTCGTAC -> TTGTGCGTGTTTTCGTACT
TTTGTGGAACATAGTGCCA -> TTGTGGAACATAGTGCCAT
TTTTCCCCTTTGAACACGG -> TTTCCCCTTTGAACACGGT
TTTTCGGGAATCGTTGCCT -> TTTCGGGAATCGTTGCCTC
TTTTCGTACTGTAGCCTCG -> TTTCGTACTGTAGCCTCGG
TTTTTCCCCTTTGAACACG -> TTTTCCCCTTTGAACACGG
TTTTTTCCCCTTTGAACAC -> TTTTTCCCCTTTGAACACG
TTTTTTTCCCCTTTGAACA -> TTTTTTCCCCTTTGAACAC