CAGCTAAAAGCCGGGGAAGG -> AGCTAAAAGCCGGGGAAGGT
CGTACAGTACGGAGAGGCGA -> GTACAGTACGGAGAGGCGAG
TCAAGGACTTACTCGCAGAG -> CAAGGACTTACTCGCAGAGA
CTGCTGTGCAAGACAGGATC -> TGCTGTGCAAGACAGGATCC
TCCATGAACATTACCGGCCG -> CCATGAACATTACCGGCCGC
CTACATTCGTTTACTGGTAC -> TACATTCGTTTACTGGTACA
CGACCTCAGGCTCGAGCTAA -> GACCTCAGGCTCGAGCTAAC
TACGGGGACCATGAGGTCAT -> ACGGGGACCATGAGGTCATG
TTCGCTGTCATCTGCTCCCG -> TCGCTGTCATCTGCTCCCGG
TCCGTACTAGGATACGTCGA -> CCGTACTAGGATACGTCGAC
GCTCACTCGGTTCATTTGCA -> CTCACTCGGTTCATTTGCAC
AGCGCCACGAAAAGTGTGAC -> GCGCCACGAAAAGTGTGACT
GGATCCACGTATGCCATGTG -> GATCCACGTATGCCATGTGA
CAACCCCTATGGAGTATTGT -> AACCCCTATGGAGTATTGTC
TTAGTGCGGATATCCTTAAG -> TAGTGCGGATATCCTTAAGA
TGACTGGCTGTGGGAGAACG -> GACTGGCTGTGGGAGAACGT
GGATACGTCGACGTATAAAC -> GATACGTCGACGTATAAACT
CACCAAGGGAACAATATGGC -> ACCAAGGGAACAATATGGCA
GAGGCGGGGTTTAAGAACGT -> AGGCGGGGTTTAAGAACGTA
AACGACCGCCCAAAATCCAC -> ACGACCGCCCAAAATCCACC
GGTCCGTACTAGGATACGTC -> GTCCGTACTAGGATACGTCG
TCCATCGTCAACAGAAAGCG -> CCATCGTCAACAGAAAGCGC
CGACGTATAAACTAATCCAA -> GACGTATAAACTAATCCAAT
AAAGTGTGACTGGCTGTGGG -> AAGTGTGACTGGCTGTGGGA
TAGTCTGAGAGAGGCGGGGT -> AGTCTGAGAGAGGCGGGGTT
TGAGCTGAAGGGCTCACTCG -> GAGCTGAAGGGCTCACTCGG
GCGCCACTCTTAACAGGGCC -> CGCCACTCTTAACAGGGCCC
AACCCCTATGGAGTATTGTC -> ACCCCTATGGAGTATTGTCC
GGTACAGTGCCCCCTACGCA -> GTACAGTGCCCCCTACGCAT
CCGTACTGGCAGATCGGCAG -> CGTACTGGCAGATCGGCAGT
ACTGGCACTCGAATGCCTAT -> CTGGCACTCGAATGCCTATC
CGTCGACGTATAAACTAATC -> GTCGACGTATAAACTAATCC
GACATGAACCCGATTGTTAC -> ACATGAACCCGATTGTTACG
CAGTGCCCCCTACGCATTAA -> AGTGCCCCCTACGCATTAAA
CTCGCAGAGACGCCTGAACC -> TCGCAGAGACGCCTGAACCA
AGACTTTTACACTTGGCCTA -> GACTTTTACACTTGGCCTAT
AGGGAACAATATGGCAGTGC -> GGGAACAATATGGCAGTGCT
GCTCGGTCCCAACCCCTATG -> CTCGGTCCCAACCCCTATGG
CGCTCCGTGCTTTCGCTGTC -> GCTCCGTGCTTTCGCTGTCA
TCGAGGTCCGTACTAGGATA -> CGAGGTCCGTACTAGGATAC
GTATAAACTAATCCAATCAC -> TATAAACTAATCCAATCACT
CGGGGTTTAAGAACGTATCC -> GGGGTTTAAGAACGTATCCG
GCAGATCGGCAGTTCAAGGA -> CAGATCGGCAGTTCAAGGAC
TGGCTGTGGGAGAACGTACA -> GGCTGTGGGAGAACGTACAG
TCACTCGGTTCATTTGCACT -> CACTCGGTTCATTTGCACTA
GACACCAAAATATGGTTTAC -> ACACCAAAATATGGTTTACT
AGAGCGTGATTATAGAGGAC -> GAGCGTGATTATAGAGGACA
GCAATGTACGACCTCAGGCT -> CAATGTACGACCTCAGGCTC
CTTCTGGTACACATCACAAC -> TTCTGGTACACATCACAACG
GCACGCGGGCTCCCAGAGCG -> CACGCGGGCTCCCAGAGCGT
ACGCATTAAAGAGATAGGCT -> CGCATTAAAGAGATAGGCTA
TGCCCGGAACCCAACGACCG -> GCCCGGAACCCAACGACCGC
ATCGGCAGTTCAAGGACTTA -> TCGGCAGTTCAAGGACTTAC
TATCCTTAAGACTTTTACAC -> ATCCTTAAGACTTTTACACT
GGCAATGTACGACCTCAGGC -> GCAATGTACGACCTCAGGCT
ATTACCGGCCGCACCTTAGT -> TTACCGGCCGCACCTTAGTG
AAGGTACCTGGCACGCGCCA -> AGGTACCTGGCACGCGCCAC
TCACCAATTCAACCGATTAC -> CACCAATTCAACCGATTACA
CTTTACTGTTCATCTATGCT -> TTTACTGTTCATCTATGCTT
TTTTGTGTGTCGCTCCGTGC -> TTTGTGTGTCGCTCCGTGCT
TGAAGGGCTCACTCGGTTCA -> GAAGGGCTCACTCGGTTCAT
GGCCGCACCTTAGTGCGGAT -> GCCGCACCTTAGTGCGGATA
CCCGTATGACCCTTTTGTGT -> CCGTATGACCCTTTTGTGTG
AAAGGGTGAGTCATCCTCCC -> AAGGGTGAGTCATCCTCCCC
ACCCACGTAGTCTGAGAGAG -> CCCACGTAGTCTGAGAGAGG
CCATGAGGTCATGACTGGCA -> CATGAGGTCATGACTGGCAC
AAGGCGTTCTCTTGCCTAAT -> AGGCGTTCTCTTGCCTAATC
TCTTTACTGTTCATCTATGC -> CTTTACTGTTCATCTATGCT
GTATTGTCCATCGTCAACAG -> TATTGTCCATCGTCAACAGA
CGGAACCCAACGACCGCCCA -> GGAACCCAACGACCGCCCAA
TGACCCTTTTGTGTGTCGCT -> GACCCTTTTGTGTGTCGCTC
GTCGAGGTCCGTACTAGGAT -> TCGAGGTCCGTACTAGGATA
TGTTCATCTATGCTTCTGGT -> GTTCATCTATGCTTCTGGTA
CAGTAATCGCGATACTCGTG -> AGTAATCGCGATACTCGTGA
AAGATCTCACCAATTCAACC -> AGATCTCACCAATTCAACCG
TTACGGGGACCATGAGGTCA -> TACGGGGACCATGAGGTCAT
AGCTGAAGGGCTCACTCGGT -> GCTGAAGGGCTCACTCGGTT
CTCCTCCATGAACATTACCG -> TCCTCCATGAACATTACCGG
TCAACAGAAAGCGCCCTCTC -> CAACAGAAAGCGCCCTCTCG
GCTCGAGCTAACGCTCGGTC -> CTCGAGCTAACGCTCGGTCC
TTGAGCGCCACGAAAAGTGT -> TGAGCGCCACGAAAAGTGTG
CATCCTCCCCAGGTACAGTG -> ATCCTCCCCAGGTACAGTGC
CATGAACATTACCGGCCGCA -> ATGAACATTACCGGCCGCAC
TCAGGCTCGAGCTAACGCTC -> CAGGCTCGAGCTAACGCTCG
CCACGTAGTCTGAGAGAGGC -> CACGTAGTCTGAGAGAGGCG
TAAGAACGTATCCGTACTGG -> AAGAACGTATCCGTACTGGC
CTCGAGCTAACGCTCGGTCC -> TCGAGCTAACGCTCGGTCCC
GCTGAAGGGCTCACTCGGTT -> CTGAAGGGCTCACTCGGTTC
TAAAAGCCGGGGAAGGTACC -> AAAAGCCGGGGAAGGTACCT
TCCAGCTAAAAGCCGGGGAA -> CCAGCTAAAAGCCGGGGAAG
AGTGCGGATATCCTTAAGAC -> GTGCGGATATCCTTAAGACT
CGGTCGAGGTCCGTACTAGG -> GGTCGAGGTCCGTACTAGGA
GTGCTCCAGCTAAAAGCCGG -> TGCTCCAGCTAAAAGCCGGG
CCGCCCAAAATCCACCAAGG -> CGCCCAAAATCCACCAAGGG
CTGGCAGATCGGCAGTTCAA -> TGGCAGATCGGCAGTTCAAG
CTCAGGCTCGAGCTAACGCT -> TCAGGCTCGAGCTAACGCTC
TGTGACTTGGAGTGGCGCAC -> GTGACTTGGAGTGGCGCACG
CGATTGTTACGGGGACCATG -> GATTGTTACGGGGACCATGA
CGTATGACCCTTTTGTGTGT -> GTATGACCCTTTTGTGTGTC
CAACGATGCCCGGAACCCAA -> AACGATGCCCGGAACCCAAC
CAGAATCTTATGCACCCACG -> AGAATCTTATGCACCCACGT
ATCTTTACTGTTCATCTATG -> TCTTTACTGTTCATCTATGC
ATCCTCCTCCATGAACATTA -> TCCTCCTCCATGAACATTAC
TGTGCAAGACAGGATCCACG -> GTGCAAGACAGGATCCACGT
GTGTGTCGCTCCGTGCTTTC -> TGTGTCGCTCCGTGCTTTCG
TCCGTGCTTTCGCTGTCATC -> CCGTGCTTTCGCTGTCATCT
ATCTACAAAAGGGTGAGTCA -> TCTACAAAAGGGTGAGTCAT
TGGCCTATGCGAGACAGAAT -> GGCCTATGCGAGACAGAATC
ATGCGAGACAGAATCTTATG -> TGCGAGACAGAATCTTATGC
GTGAGCTGAAGGGCTCACTC -> TGAGCTGAAGGGCTCACTCG
AGCGCCCTCTCGACAAGATC -> GCGCCCTCTCGACAAGATCT
ATTTGCACTACATTCGTTTA -> TTTGCACTACATTCGTTTAC
GTCCATCGTCAACAGAAAGC -> TCCATCGTCAACAGAAAGCG
ACTCGAATGCCTATCTACAA -> CTCGAATGCCTATCTACAAA
CCCACGTAGTCTGAGAGAGG -> CCACGTAGTCTGAGAGAGGC
ATCCGTACTGGCAGATCGGC -> TCCGTACTGGCAGATCGGCA
CCCTATGGAGTATTGTCCAT -> CCTATGGAGTATTGTCCATC
GCCTAAAGGCGTTCTCTTGC -> CCTAAAGGCGTTCTCTTGCC
GACGCCTGAACCACCCTCTG -> ACGCCTGAACCACCCTCTGA
ACATTACCGGCCGCACCTTA -> CATTACCGGCCGCACCTTAG
ATCCTCCCCAGGTACAGTGC -> TCCTCCCCAGGTACAGTGCC
GAGGTCCGTACTAGGATACG -> AGGTCCGTACTAGGATACGT
AGGATCCACGTATGCCATGT -> GGATCCACGTATGCCATGTG
GGAACAATATGGCAGTGCTC -> GAACAATATGGCAGTGCTCC
TCCTCCATGAACATTACCGG -> CCTCCATGAACATTACCGGC
AACTAATCCAATCACTTTGA -> ACTAATCCAATCACTTTGAG
GCAAGACAGGATCCACGTAT -> CAAGACAGGATCCACGTATG
CTGTCATCTGCTCCCGGGCA -> TGTCATCTGCTCCCGGGCAA
ACCACCCTCTGACAAAGGTA -> CCACCCTCTGACAAAGGTAA
GGTCATGACTGGCACTCGAA -> GTCATGACTGGCACTCGAAT
TATGGCAGTGCTCCAGCTAA -> ATGGCAGTGCTCCAGCTAAA
AATATGGTTTACTGCCTAAA -> ATATGGTTTACTGCCTAAAG
TAAACTAATCCAATCACTTT -> AAACTAATCCAATCACTTTG
GAGATAGGCTAGCGGCTCAG -> AGATAGGCTAGCGGCTCAGT
GCCCAAAATCCACCAAGGGA -> CCCAAAATCCACCAAGGGAA
GCCCGTATGACCCTTTTGTG -> CCCGTATGACCCTTTTGTGT
AAATCCTCCTCCATGAACAT -> AATCCTCCTCCATGAACATT
AGCCGGGGAAGGTACCTGGC -> GCCGGGGAAGGTACCTGGCA
AGAGATAGGCTAGCGGCTCA -> GAGATAGGCTAGCGGCTCAG
ACGCTCGGTCCCAACCCCTA -> CGCTCGGTCCCAACCCCTAT
GGAGATCCCGCGTCTGCTGT -> GAGATCCCGCGTCTGCTGTG
ACAGAATCTTATGCACCCAC -> CAGAATCTTATGCACCCACG
TCTTAACAGGGCCCGTATGA -> CTTAACAGGGCCCGTATGAC
GCACTCGAATGCCTATCTAC -> CACTCGAATGCCTATCTACA
GCGGGCTCCCAGAGCGTGAT -> CGGGCTCCCAGAGCGTGATT
TCGACGTATAAACTAATCCA -> CGACGTATAAACTAATCCAA
TAAAGGCGTTCTCTTGCCTA -> AAAGGCGTTCTCTTGCCTAA
GCTAACGCTCGGTCCCAACC -> CTAACGCTCGGTCCCAACCC
TACGACCTCAGGCTCGAGCT -> ACGACCTCAGGCTCGAGCTA
GAGTGGCGCACGCGGGCTCC -> AGTGGCGCACGCGGGCTCCC
ACCCTTTTGTGTGTCGCTCC -> CCCTTTTGTGTGTCGCTCCG
ACAAAAGGGTGAGTCATCCT -> CAAAAGGGTGAGTCATCCTC
TCACAACGATGCCCGGAACC -> CACAACGATGCCCGGAACCC
ATGCCTATCTACAAAAGGGT -> TGCCTATCTACAAAAGGGTG
CGACAAGATCTCACCAATTC -> GACAAGATCTCACCAATTCA
GCCATGTGACTTGGAGTGGC -> CCATGTGACTTGGAGTGGCG
AACAGGGCCCGTATGACCCT -> ACAGGGCCCGTATGACCCTT
AGTCATCCTCCCCAGGTACA -> GTCATCCTCCCCAGGTACAG
AAGAACGTATCCGTACTGGC -> AGAACGTATCCGTACTGGCA
AAGCCGGGGAAGGTACCTGG -> AGCCGGGGAAGGTACCTGGC
ACTTGGAGTGGCGCACGCGG -> CTTGGAGTGGCGCACGCGGG
CATCTGCTCCCGGGCAATGT -> ATCTGCTCCCGGGCAATGTA
AAGGGTGAGTCATCCTCCCC -> AGGGTGAGTCATCCTCCCCA
ACAAATGCAGACCAGCGGTC -> CAAATGCAGACCAGCGGTCG
CGGCCGCACCTTAGTGCGGA -> GGCCGCACCTTAGTGCGGAT
GAGAGGCGGGGTTTAAGAAC -> AGAGGCGGGGTTTAAGAACG
GAACCCAACGACCGCCCAAA -> AACCCAACGACCGCCCAAAA
ACGCGCCACTCTTAACAGGG -> CGCGCCACTCTTAACAGGGC
TTCATCTATGCTTCTGGTAC -> TCATCTATGCTTCTGGTACA
TCGGTTCATTTGCACTACAT -> CGGTTCATTTGCACTACATT
TATGGTTTACTGCCTAAAGG -> ATGGTTTACTGCCTAAAGGC
AAATGCAGACCAGCGGTCGA -> AATGCAGACCAGCGGTCGAG
TCAACCGATTACATGTCTGC -> CAACCGATTACATGTCTGCC
AGAGGCGGGGTTTAAGAACG -> GAGGCGGGGTTTAAGAACGT
AGATCTCACCAATTCAACCG -> GATCTCACCAATTCAACCGA
ACACCAAAATATGGTTTACT -> CACCAAAATATGGTTTACTG
AGAGAGGCGGGGTTTAAGAA -> GAGAGGCGGGGTTTAAGAAC
GCCTATGCGAGACAGAATCT -> CCTATGCGAGACAGAATCTT
CGTTCTCTTGCCTAATCTTT -> GTTCTCTTGCCTAATCTTTG
AAGGGCTCACTCGGTTCATT -> AGGGCTCACTCGGTTCATTT
ACTCGCAGAGACGCCTGAAC -> CTCGCAGAGACGCCTGAACC
ACGTACAGTACGGAGAGGCG -> CGTACAGTACGGAGAGGCGA
TTTCGCTGTCATCTGCTCCC -> TTCGCTGTCATCTGCTCCCG
AGTGGCGCACGCGGGCTCCC -> GTGGCGCACGCGGGCTCCCA
CATTAAAGAGATAGGCTAGC -> ATTAAAGAGATAGGCTAGCG
CCAACCCCTATGGAGTATTG -> CAACCCCTATGGAGTATTGT
TGCCACATATGACATGAACC -> GCCACATATGACATGAACCC
GGCTCAGTAATCGCGATACT -> GCTCAGTAATCGCGATACTC
CTAGGATACGTCGACGTATA -> TAGGATACGTCGACGTATAA
CATTTGCACTACATTCGTTT -> ATTTGCACTACATTCGTTTA
GTTCATTTGCACTACATTCG -> TTCATTTGCACTACATTCGT
TACATGTCTGCCACATATGA -> ACATGTCTGCCACATATGAC
CATTCGTTTACTGGTACAAA -> ATTCGTTTACTGGTACAAAT
CTACAAAAGGGTGAGTCATC -> TACAAAAGGGTGAGTCATCC
TTCTCTTGCCTAATCTTTGA -> TCTCTTGCCTAATCTTTGAT
CCACATATGACATGAACCCG -> CACATATGACATGAACCCGA
TATAAACTAATCCAATCACT -> ATAAACTAATCCAATCACTT
TCTCTTGCCTAATCTTTGAT -> CTCTTGCCTAATCTTTGATC
GGCTAGCGGCTCAGTAATCG -> GCTAGCGGCTCAGTAATCGC
GCTCCAGCTAAAAGCCGGGG -> CTCCAGCTAAAAGCCGGGGA
AGTATTGTCCATCGTCAACA -> GTATTGTCCATCGTCAACAG
GATACTCGTGAGCTGAAGGG -> ATACTCGTGAGCTGAAGGGC
CCTTAGTGCGGATATCCTTA -> CTTAGTGCGGATATCCTTAA
TGCTTTCGCTGTCATCTGCT -> GCTTTCGCTGTCATCTGCTC
TAGGATACGTCGACGTATAA -> AGGATACGTCGACGTATAAA
TTCATTTGCACTACATTCGT -> TCATTTGCACTACATTCGTT
GCAGAGACGCCTGAACCACC -> CAGAGACGCCTGAACCACCC
TGGTTTACTGCCTAAAGGCG -> GGTTTACTGCCTAAAGGCGT
GTAACATATCTTTACTGTTC -> TAACATATCTTTACTGTTCA
GACTTACTCGCAGAGACGCC -> ACTTACTCGCAGAGACGCCT
AATCCACCAAGGGAACAATA -> ATCCACCAAGGGAACAATAT
TATGGAGTATTGTCCATCGT -> ATGGAGTATTGTCCATCGTC
TGACATGAACCCGATTGTTA -> GACATGAACCCGATTGTTAC
ATGAGGTCATGACTGGCACT -> TGAGGTCATGACTGGCACTC
ACCCCTATGGAGTATTGTCC -> CCCCTATGGAGTATTGTCCA
ACTGGTACAAATGCAGACCA -> CTGGTACAAATGCAGACCAG
CTCGGTCCCAACCCCTATGG -> TCGGTCCCAACCCCTATGGA
GTATGCCATGTGACTTGGAG -> TATGCCATGTGACTTGGAGT
AAAGCCGGGGAAGGTACCTG -> AAGCCGGGGAAGGTACCTGG
GAGCTAACGCTCGGTCCCAA -> AGCTAACGCTCGGTCCCAAC
GGGGAAGGTACCTGGCACGC -> GGGAAGGTACCTGGCACGCG
CGCCTGAACCACCCTCTGAC -> GCCTGAACCACCCTCTGACA
TGCACTACATTCGTTTACTG -> GCACTACATTCGTTTACTGG
CGCTCGGTCCCAACCCCTAT -> GCTCGGTCCCAACCCCTATG
GCCGGGGAAGGTACCTGGCA -> CCGGGGAAGGTACCTGGCAC
CAAGGGAACAATATGGCAGT -> AAGGGAACAATATGGCAGTG
TGTTACGGGGACCATGAGGT -> GTTACGGGGACCATGAGGTC
CCAATCACTTTGAGCGCCAC -> CAATCACTTTGAGCGCCACG
CGCACCTTAGTGCGGATATC -> GCACCTTAGTGCGGATATCC
CTGGCACGCGCCACTCTTAA -> TGGCACGCGCCACTCTTAAC
AGAACGTACAGTACGGAGAG -> GAACGTACAGTACGGAGAGG
CGTGATTATAGAGGACACCA -> GTGATTATAGAGGACACCAA
CAGGATCCACGTATGCCATG -> AGGATCCACGTATGCCATGT
CAGGCTCGAGCTAACGCTCG -> AGGCTCGAGCTAACGCTCGG
GTGACTGGCTGTGGGAGAAC -> TGACTGGCTGTGGGAGAACG
CCATGAACATTACCGGCCGC -> CATGAACATTACCGGCCGCA
CCCGATTGTTACGGGGACCA -> CCGATTGTTACGGGGACCAT
CCCAACCCCTATGGAGTATT -> CCAACCCCTATGGAGTATTG
TCCGTACTGGCAGATCGGCA -> CCGTACTGGCAGATCGGCAG
TCAGTAATCGCGATACTCGT -> CAGTAATCGCGATACTCGTG
TGCGAGACAGAATCTTATGC -> GCGAGACAGAATCTTATGCA
TCCAATCACTTTGAGCGCCA -> CCAATCACTTTGAGCGCCAC
ACTCGTGAGCTGAAGGGCTC -> CTCGTGAGCTGAAGGGCTCA
CCTCTGACAAAGGTAACATA -> CTCTGACAAAGGTAACATAT
ATGCAGACCAGCGGTCGAGG -> TGCAGACCAGCGGTCGAGGT
CCTCAGGCTCGAGCTAACGC -> CTCAGGCTCGAGCTAACGCT
CAGTGCTCCAGCTAAAAGCC -> AGTGCTCCAGCTAAAAGCCG
CTTAAGACTTTTACACTTGG -> TTAAGACTTTTACACTTGGC
CCCGGGCAATGTACGACCTC -> CCGGGCAATGTACGACCTCA
CGACCGCCCAAAATCCACCA -> GACCGCCCAAAATCCACCAA
CTTATGCACCCACGTAGTCT -> TTATGCACCCACGTAGTCTG
TGCACCCACGTAGTCTGAGA -> GCACCCACGTAGTCTGAGAG
ATTACATGTCTGCCACATAT -> TTACATGTCTGCCACATATG
CCCCCTACGCATTAAAGAGA -> CCCCTACGCATTAAAGAGAT
AATCGCGATACTCGTGAGCT -> ATCGCGATACTCGTGAGCTG
TACAGTGCCCCCTACGCATT -> ACAGTGCCCCCTACGCATTA
TGCCTATCTACAAAAGGGTG -> GCCTATCTACAAAAGGGTGA
CCTTTTGTGTGTCGCTCCGT -> CTTTTGTGTGTCGCTCCGTG
CCTTAAGACTTTTACACTTG -> CTTAAGACTTTTACACTTGG
GCCACGAAAAGTGTGACTGG -> CCACGAAAAGTGTGACTGGC
ACTCTTAACAGGGCCCGTAT -> CTCTTAACAGGGCCCGTATG
ATGACTGGCACTCGAATGCC -> TGACTGGCACTCGAATGCCT
AATCACTTTGAGCGCCACGA -> ATCACTTTGAGCGCCACGAA
TTACTGCCTAAAGGCGTTCT -> TACTGCCTAAAGGCGTTCTC
TTTACTGTTCATCTATGCTT -> TTACTGTTCATCTATGCTTC
ATGAACATTACCGGCCGCAC -> TGAACATTACCGGCCGCACC
TGACAAAGGTAACATATCTT -> GACAAAGGTAACATATCTTT
GTCATGACTGGCACTCGAAT -> TCATGACTGGCACTCGAATG
AATTCAACCGATTACATGTC -> ATTCAACCGATTACATGTCT
GTTTACTGGTACAAATGCAG -> TTTACTGGTACAAATGCAGA
GCGGGGTTTAAGAACGTATC -> CGGGGTTTAAGAACGTATCC
CGGCTCAGTAATCGCGATAC -> GGCTCAGTAATCGCGATACT
CTCCCAGAGCGTGATTATAG -> TCCCAGAGCGTGATTATAGA
CGCGGGCTCCCAGAGCGTGA -> GCGGGCTCCCAGAGCGTGAT
GACCGCCCAAAATCCACCAA -> ACCGCCCAAAATCCACCAAG
TTTACTGGTACAAATGCAGA -> TTACTGGTACAAATGCAGAC
TGCCTAATCTTTGATCGGGA -> GCCTAATCTTTGATCGGGAA
GCGCCCTCTCGACAAGATCT -> CGCCCTCTCGACAAGATCTC
GGCTCGAGCTAACGCTCGGT -> GCTCGAGCTAACGCTCGGTC
CCAAAATATGGTTTACTGCC -> CAAAATATGGTTTACTGCCT
GATGCCCGGAACCCAACGAC -> ATGCCCGGAACCCAACGACC
CGCCCTCTCGACAAGATCTC -> GCCCTCTCGACAAGATCTCA
GACAAAGGTAACATATCTTT -> ACAAAGGTAACATATCTTTA
TACCTGGCACGCGCCACTCT -> ACCTGGCACGCGCCACTCTT
CCCAGGTACAGTGCCCCCTA -> CCAGGTACAGTGCCCCCTAC
CCTAAAGGCGTTCTCTTGCC -> CTAAAGGCGTTCTCTTGCCT
CTGAGAGAGGCGGGGTTTAA -> TGAGAGAGGCGGGGTTTAAG
CTGACAAAGGTAACATATCT -> TGACAAAGGTAACATATCTT
GCTGTCATCTGCTCCCGGGC -> CTGTCATCTGCTCCCGGGCA
GTGAGTCATCCTCCCCAGGT -> TGAGTCATCCTCCCCAGGTA
CTCGAATGCCTATCTACAAA -> TCGAATGCCTATCTACAAAA
TGGCACGCGCCACTCTTAAC -> GGCACGCGCCACTCTTAACA
CTCCCCAGGTACAGTGCCCC -> TCCCCAGGTACAGTGCCCCC
GAAAAGTGTGACTGGCTGTG -> AAAAGTGTGACTGGCTGTGG
GTGCTTTCGCTGTCATCTGC -> TGCTTTCGCTGTCATCTGCT
ACGTATAAACTAATCCAATC -> CGTATAAACTAATCCAATCA
CACGAAAAGTGTGACTGGCT -> ACGAAAAGTGTGACTGGCTG
ATAGAGGACACCAAAATATG -> TAGAGGACACCAAAATATGG
GAGACGCCTGAACCACCCTC -> AGACGCCTGAACCACCCTCT
GGTAACATATCTTTACTGTT -> GTAACATATCTTTACTGTTC
ACAGGATCCACGTATGCCAT -> CAGGATCCACGTATGCCATG
ACAAGATCTCACCAATTCAA -> CAAGATCTCACCAATTCAAC
TCGGTCCCAACCCCTATGGA -> CGGTCCCAACCCCTATGGAG
GGTACAAATGCAGACCAGCG -> GTACAAATGCAGACCAGCGG
ACATATCTTTACTGTTCATC -> CATATCTTTACTGTTCATCT
CACCCTCTGACAAAGGTAAC -> ACCCTCTGACAAAGGTAACA
GACTTTTACACTTGGCCTAT -> ACTTTTACACTTGGCCTATG
TATGCTTCTGGTACACATCA -> ATGCTTCTGGTACACATCAC
AAGCGCCCTCTCGACAAGAT -> AGCGCCCTCTCGACAAGATC
GAGAGAGGCGGGGTTTAAGA -> AGAGAGGCGGGGTTTAAGAA
TCCTCCCCAGGTACAGTGCC -> CCTCCCCAGGTACAGTGCCC
TTAAGACTTTTACACTTGGC -> TAAGACTTTTACACTTGGCC
GAATGCCTATCTACAAAAGG -> AATGCCTATCTACAAAAGGG
ACTTGGCCTATGCGAGACAG -> CTTGGCCTATGCGAGACAGA
CAAAATCCACCAAGGGAACA -> AAAATCCACCAAGGGAACAA
GTATGACCCTTTTGTGTGTC -> TATGACCCTTTTGTGTGTCG
ATCTGCTCCCGGGCAATGTA -> TCTGCTCCCGGGCAATGTAC
CGGTCCCAACCCCTATGGAG -> GGTCCCAACCCCTATGGAGT
TGTCGCTCCGTGCTTTCGCT -> GTCGCTCCGTGCTTTCGCTG
AGAAAGCGCCCTCTCGACAA -> GAAAGCGCCCTCTCGACAAG
CACGCGCCACTCTTAACAGG -> ACGCGCCACTCTTAACAGGG
CTAAAGGCGTTCTCTTGCCT -> TAAAGGCGTTCTCTTGCCTA
CCTCTCGACAAGATCTCACC -> CTCTCGACAAGATCTCACCA
ATATGACATGAACCCGATTG -> TATGACATGAACCCGATTGT
GTCGACGTATAAACTAATCC -> TCGACGTATAAACTAATCCA
AGGACACCAAAATATGGTTT -> GGACACCAAAATATGGTTTA
ACTGTTCATCTATGCTTCTG -> CTGTTCATCTATGCTTCTGG
CCTAATCTTTGATCGGGAAA -> CTAATCTTTGATCGGGAAAA
CACTTGGCCTATGCGAGACA -> ACTTGGCCTATGCGAGACAG
GCACCCACGTAGTCTGAGAG -> CACCCACGTAGTCTGAGAGA
AGTGCTCCAGCTAAAAGCCG -> GTGCTCCAGCTAAAAGCCGG
GGTTTAAGAACGTATCCGTA -> GTTTAAGAACGTATCCGTAC
ATGACATGAACCCGATTGTT -> TGACATGAACCCGATTGTTA
AAAATATGGTTTACTGCCTA -> AAATATGGTTTACTGCCTAA
ACAGGGCCCGTATGACCCTT -> CAGGGCCCGTATGACCCTTT
TGAGAGAGGCGGGGTTTAAG -> GAGAGAGGCGGGGTTTAAGA
CCAATTCAACCGATTACATG -> CAATTCAACCGATTACATGT
GCTCAGTAATCGCGATACTC -> CTCAGTAATCGCGATACTCG
GCTAAAAGCCGGGGAAGGTA -> CTAAAAGCCGGGGAAGGTAC
CTATGGAGTATTGTCCATCG -> TATGGAGTATTGTCCATCGT
TAATCGCGATACTCGTGAGC -> AATCGCGATACTCGTGAGCT
GGTCCCAACCCCTATGGAGT -> GTCCCAACCCCTATGGAGTA
ACACATCACAACGATGCCCG -> CACATCACAACGATGCCCGG
AAAAGTGTGACTGGCTGTGG -> AAAGTGTGACTGGCTGTGGG
CTTGGCCTATGCGAGACAGA -> TTGGCCTATGCGAGACAGAA
GCGTTCTCTTGCCTAATCTT -> CGTTCTCTTGCCTAATCTTT
GATACGTCGACGTATAAACT -> ATACGTCGACGTATAAACTA
CCGTATGACCCTTTTGTGTG -> CGTATGACCCTTTTGTGTGT
TGCCTAAAGGCGTTCTCTTG -> GCCTAAAGGCGTTCTCTTGC
AACCCAACGACCGCCCAAAA -> ACCCAACGACCGCCCAAAAT
ATGCACCCACGTAGTCTGAG -> TGCACCCACGTAGTCTGAGA
TTACTGGTACAAATGCAGAC -> TACTGGTACAAATGCAGACC
AGGTCCGTACTAGGATACGT -> GGTCCGTACTAGGATACGTC
GAGCGCCACGAAAAGTGTGA -> AGCGCCACGAAAAGTGTGAC
TATCTACAAAAGGGTGAGTC -> ATCTACAAAAGGGTGAGTCA
ACAGAAAGCGCCCTCTCGAC -> CAGAAAGCGCCCTCTCGACA
CACATATGACATGAACCCGA -> ACATATGACATGAACCCGAT
GTCAACAGAAAGCGCCCTCT -> TCAACAGAAAGCGCCCTCTC
AAAGAGATAGGCTAGCGGCT -> AAGAGATAGGCTAGCGGCTC
CGCGATACTCGTGAGCTGAA -> GCGATACTCGTGAGCTGAAG
GGGGTTTAAGAACGTATCCG -> GGGTTTAAGAACGTATCCGT
TGACTTGGAGTGGCGCACGC -> GACTTGGAGTGGCGCACGCG
GAGTATTGTCCATCGTCAAC -> AGTATTGTCCATCGTCAACA
TGTCCATCGTCAACAGAAAG -> GTCCATCGTCAACAGAAAGC
GCTCCGTGCTTTCGCTGTCA -> CTCCGTGCTTTCGCTGTCAT
GATCTCACCAATTCAACCGA -> ATCTCACCAATTCAACCGAT
AACCGATTACATGTCTGCCA -> ACCGATTACATGTCTGCCAC
AATCTTATGCACCCACGTAG -> ATCTTATGCACCCACGTAGT
ATCACTTTGAGCGCCACGAA -> TCACTTTGAGCGCCACGAAA
GCGCCACGAAAAGTGTGACT -> CGCCACGAAAAGTGTGACTG
TAATCTTTGATCGGGAAAAT -> AATCTTTGATCGGGAAAATC
TTAAGAACGTATCCGTACTG -> TAAGAACGTATCCGTACTGG
CTGAACCACCCTCTGACAAA -> TGAACCACCCTCTGACAAAG
TCGACAAGATCTCACCAATT -> CGACAAGATCTCACCAATTC
TGTGTCGCTCCGTGCTTTCG -> GTGTCGCTCCGTGCTTTCGC
CGCTGTCATCTGCTCCCGGG -> GCTGTCATCTGCTCCCGGGC
AGTCTGAGAGAGGCGGGGTT -> GTCTGAGAGAGGCGGGGTTT
CTTTGAGCGCCACGAAAAGT -> TTTGAGCGCCACGAAAAGTG
GTACAGTACGGAGAGGCGAG -> TACAGTACGGAGAGGCGAGG
GTATCCGTACTGGCAGATCG -> TATCCGTACTGGCAGATCGG
GCAGACCAGCGGTCGAGGTC -> CAGACCAGCGGTCGAGGTCC
GCTTCTGGTACACATCACAA -> CTTCTGGTACACATCACAAC
GGCGGGGTTTAAGAACGTAT -> GCGGGGTTTAAGAACGTATC
GGCGCACGCGGGCTCCCAGA -> GCGCACGCGGGCTCCCAGAG
CACAACGATGCCCGGAACCC -> ACAACGATGCCCGGAACCCA
ACACTTGGCCTATGCGAGAC -> CACTTGGCCTATGCGAGACA
GACCAGCGGTCGAGGTCCGT -> ACCAGCGGTCGAGGTCCGTA
CTGGCACTCGAATGCCTATC -> TGGCACTCGAATGCCTATCT
AAGGACTTACTCGCAGAGAC -> AGGACTTACTCGCAGAGACG
CTTACTCGCAGAGACGCCTG -> TTACTCGCAGAGACGCCTGA
CCCAACGACCGCCCAAAATC -> CCAACGACCGCCCAAAATCC
GCCACTCTTAACAGGGCCCG -> CCACTCTTAACAGGGCCCGT
CAATCACTTTGAGCGCCACG -> AATCACTTTGAGCGCCACGA
CATCTATGCTTCTGGTACAC -> ATCTATGCTTCTGGTACACA
ACATCACAACGATGCCCGGA -> CATCACAACGATGCCCGGAA
CCTATGCGAGACAGAATCTT -> CTATGCGAGACAGAATCTTA
ACGTATGCCATGTGACTTGG -> CGTATGCCATGTGACTTGGA
CGTTTACTGGTACAAATGCA -> GTTTACTGGTACAAATGCAG
TAACGCTCGGTCCCAACCCC -> AACGCTCGGTCCCAACCCCT
GATCCCGCGTCTGCTGTGCA -> ATCCCGCGTCTGCTGTGCAA
CTCTGACAAAGGTAACATAT -> TCTGACAAAGGTAACATATC
TAGAGGACACCAAAATATGG -> AGAGGACACCAAAATATGGT
CCAACGACCGCCCAAAATCC -> CAACGACCGCCCAAAATCCA
GCCCTCTCGACAAGATCTCA -> CCCTCTCGACAAGATCTCAC
CACCTTAGTGCGGATATCCT -> ACCTTAGTGCGGATATCCTT
CAGATCGGCAGTTCAAGGAC -> AGATCGGCAGTTCAAGGACT
TGCTCCAGCTAAAAGCCGGG -> GCTCCAGCTAAAAGCCGGGG
TCCCGGGCAATGTACGACCT -> CCCGGGCAATGTACGACCTC
GTACTAGGATACGTCGACGT -> TACTAGGATACGTCGACGTA
AACAGAAAGCGCCCTCTCGA -> ACAGAAAGCGCCCTCTCGAC
ACCTTAGTGCGGATATCCTT -> CCTTAGTGCGGATATCCTTA
CTGGTACAAATGCAGACCAG -> TGGTACAAATGCAGACCAGC
CGGATATCCTTAAGACTTTT -> GGATATCCTTAAGACTTTTA
CCTCCATGAACATTACCGGC -> CTCCATGAACATTACCGGCC
CTTTTACACTTGGCCTATGC -> TTTTACACTTGGCCTATGCG
TATGCACCCACGTAGTCTGA -> ATGCACCCACGTAGTCTGAG
GTGATTATAGAGGACACCAA -> TGATTATAGAGGACACCAAA
GCCTGAACCACCCTCTGACA -> CCTGAACCACCCTCTGACAA
CCGATTGTTACGGGGACCAT -> CGATTGTTACGGGGACCATG
CTAGCGGCTCAGTAATCGCG -> TAGCGGCTCAGTAATCGCGA
GCAGTGCTCCAGCTAAAAGC -> CAGTGCTCCAGCTAAAAGCC
ACTAGGATACGTCGACGTAT -> CTAGGATACGTCGACGTATA
GACTGGCACTCGAATGCCTA -> ACTGGCACTCGAATGCCTAT
GGCCCGTATGACCCTTTTGT -> GCCCGTATGACCCTTTTGTG
GACAGGATCCACGTATGCCA -> ACAGGATCCACGTATGCCAT
TATTGTCCATCGTCAACAGA -> ATTGTCCATCGTCAACAGAA
TGTGGGAGAACGTACAGTAC -> GTGGGAGAACGTACAGTACG
ATGTGACTTGGAGTGGCGCA -> TGTGACTTGGAGTGGCGCAC
TGGTACAAATGCAGACCAGC -> GGTACAAATGCAGACCAGCG
ACGCCTGAACCACCCTCTGA -> CGCCTGAACCACCCTCTGAC
CCCTTTTGTGTGTCGCTCCG -> CCTTTTGTGTGTCGCTCCGT
TCCTTAAGACTTTTACACTT -> CCTTAAGACTTTTACACTTG
AAAGGTAACATATCTTTACT -> AAGGTAACATATCTTTACTG
CACTTTGAGCGCCACGAAAA -> ACTTTGAGCGCCACGAAAAG
CGGGCAATGTACGACCTCAG -> GGGCAATGTACGACCTCAGG
AAGGTAACATATCTTTACTG -> AGGTAACATATCTTTACTGT
TTATGCACCCACGTAGTCTG -> TATGCACCCACGTAGTCTGA
ACCGCCCAAAATCCACCAAG -> CCGCCCAAAATCCACCAAGG
GTGCAAGACAGGATCCACGT -> TGCAAGACAGGATCCACGTA
GTGTGACTGGCTGTGGGAGA -> TGTGACTGGCTGTGGGAGAA
TCGAGCTAACGCTCGGTCCC -> CGAGCTAACGCTCGGTCCCA
GCACCTTAGTGCGGATATCC -> CACCTTAGTGCGGATATCCT
GGCAGATCGGCAGTTCAAGG -> GCAGATCGGCAGTTCAAGGA
TGAGCGCCACGAAAAGTGTG -> GAGCGCCACGAAAAGTGTGA
CACTACATTCGTTTACTGGT -> ACTACATTCGTTTACTGGTA
TCGTGAGCTGAAGGGCTCAC -> CGTGAGCTGAAGGGCTCACT
TGTCTGCCACATATGACATG -> GTCTGCCACATATGACATGA
AGGCTCGAGCTAACGCTCGG -> GGCTCGAGCTAACGCTCGGT
CCACCCTCTGACAAAGGTAA -> CACCCTCTGACAAAGGTAAC
CGCGTCTGCTGTGCAAGACA -> GCGTCTGCTGTGCAAGACAG
AGCTAAAAGCCGGGGAAGGT -> GCTAAAAGCCGGGGAAGGTA
ACGAAAAGTGTGACTGGCTG -> CGAAAAGTGTGACTGGCTGT
GTGCGGATATCCTTAAGACT -> TGCGGATATCCTTAAGACTT
TTTGAGCGCCACGAAAAGTG -> TTGAGCGCCACGAAAAGTGT
TTTGCACTACATTCGTTTAC -> TTGCACTACATTCGTTTACT
TGGAGTGGCGCACGCGGGCT -> GGAGTGGCGCACGCGGGCTC
TCGCTCCGTGCTTTCGCTGT -> CGCTCCGTGCTTTCGCTGTC
CTTGGAGTGGCGCACGCGGG -> TTGGAGTGGCGCACGCGGGC
TCGTCAACAGAAAGCGCCCT -> CGTCAACAGAAAGCGCCCTC
CTAACGCTCGGTCCCAACCC -> TAACGCTCGGTCCCAACCCC
GGGCCCGTATGACCCTTTTG -> GGCCCGTATGACCCTTTTGT
CGAAAAGTGTGACTGGCTGT -> GAAAAGTGTGACTGGCTGTG
CGCAGAGACGCCTGAACCAC -> GCAGAGACGCCTGAACCACC
GATATCCTTAAGACTTTTAC -> ATATCCTTAAGACTTTTACA
CATTACCGGCCGCACCTTAG -> ATTACCGGCCGCACCTTAGT
CCAGCTAAAAGCCGGGGAAG -> CAGCTAAAAGCCGGGGAAGG
CTGCCTAAAGGCGTTCTCTT -> TGCCTAAAGGCGTTCTCTTG
CGTCTGCTGTGCAAGACAGG -> GTCTGCTGTGCAAGACAGGA
ATCCCGCGTCTGCTGTGCAA -> TCCCGCGTCTGCTGTGCAAG
TTACTCGCAGAGACGCCTGA -> TACTCGCAGAGACGCCTGAA
ATTCAACCGATTACATGTCT -> TTCAACCGATTACATGTCTG
CCGTACTAGGATACGTCGAC -> CGTACTAGGATACGTCGACG
TTACTGTTCATCTATGCTTC -> TACTGTTCATCTATGCTTCT
GGGAAGGTACCTGGCACGCG -> GGAAGGTACCTGGCACGCGC
AGGCGTTCTCTTGCCTAATC -> GGCGTTCTCTTGCCTAATCT
CCAAGGGAACAATATGGCAG -> CAAGGGAACAATATGGCAGT
TTGATCGGGAAAATCCTCCT -> TGATCGGGAAAATCCTCCTC
GACCCTTTTGTGTGTCGCTC -> ACCCTTTTGTGTGTCGCTCC
TTGCCTAATCTTTGATCGGG -> TGCCTAATCTTTGATCGGGA
CAACCGATTACATGTCTGCC -> AACCGATTACATGTCTGCCA
CCACCAAGGGAACAATATGG -> CACCAAGGGAACAATATGGC
AGACGCCTGAACCACCCTCT -> GACGCCTGAACCACCCTCTG
CAATGTACGACCTCAGGCTC -> AATGTACGACCTCAGGCTCG
CACGTAGTCTGAGAGAGGCG -> ACGTAGTCTGAGAGAGGCGG
AACATATCTTTACTGTTCAT -> ACATATCTTTACTGTTCATC
CCCAGAGCGTGATTATAGAG -> CCAGAGCGTGATTATAGAGG
AAGTGTGACTGGCTGTGGGA -> AGTGTGACTGGCTGTGGGAG
TGCTCCCGGGCAATGTACGA -> GCTCCCGGGCAATGTACGAC
CCTGAACCACCCTCTGACAA -> CTGAACCACCCTCTGACAAA
AGACCAGCGGTCGAGGTCCG -> GACCAGCGGTCGAGGTCCGT
CGTACTGGCAGATCGGCAGT -> GTACTGGCAGATCGGCAGTT
CACGCGGGCTCCCAGAGCGT -> ACGCGGGCTCCCAGAGCGTG
CTCTTAACAGGGCCCGTATG -> TCTTAACAGGGCCCGTATGA
AACGATGCCCGGAACCCAAC -> ACGATGCCCGGAACCCAACG
TTTACACTTGGCCTATGCGA -> TTACACTTGGCCTATGCGAG
TTACACTTGGCCTATGCGAG -> TACACTTGGCCTATGCGAGA
TACTGTTCATCTATGCTTCT -> ACTGTTCATCTATGCTTCTG
TAACATATCTTTACTGTTCA -> AACATATCTTTACTGTTCAT
GGGCTCACTCGGTTCATTTG -> GGCTCACTCGGTTCATTTGC
CCTCCTCCATGAACATTACC -> CTCCTCCATGAACATTACCG
AGCGTGATTATAGAGGACAC -> GCGTGATTATAGAGGACACC
CTTTCGCTGTCATCTGCTCC -> TTTCGCTGTCATCTGCTCCC
TATCCGTACTGGCAGATCGG -> ATCCGTACTGGCAGATCGGC
TGTGACTGGCTGTGGGAGAA -> GTGACTGGCTGTGGGAGAAC
AGGTACCTGGCACGCGCCAC -> GGTACCTGGCACGCGCCACT
CCTATCTACAAAAGGGTGAG -> CTATCTACAAAAGGGTGAGT
CATCACAACGATGCCCGGAA -> ATCACAACGATGCCCGGAAC
TTTGTGTGTCGCTCCGTGCT -> TTGTGTGTCGCTCCGTGCTT
TCTGCCACATATGACATGAA -> CTGCCACATATGACATGAAC
TGGAGTATTGTCCATCGTCA -> GGAGTATTGTCCATCGTCAA
GCGTGATTATAGAGGACACC -> CGTGATTATAGAGGACACCA
ATACGTCGACGTATAAACTA -> TACGTCGACGTATAAACTAA
AGCGGCTCAGTAATCGCGAT -> GCGGCTCAGTAATCGCGATA
CAGAGACGCCTGAACCACCC -> AGAGACGCCTGAACCACCCT
CTTAGTGCGGATATCCTTAA -> TTAGTGCGGATATCCTTAAG
GACTTGGAGTGGCGCACGCG -> ACTTGGAGTGGCGCACGCGG
CCCAAAATCCACCAAGGGAA -> CCAAAATCCACCAAGGGAAC
GCACTACATTCGTTTACTGG -> CACTACATTCGTTTACTGGT
GTGCCCCCTACGCATTAAAG -> TGCCCCCTACGCATTAAAGA
ATCCAATCACTTTGAGCGCC -> TCCAATCACTTTGAGCGCCA
CAAGATCTCACCAATTCAAC -> AAGATCTCACCAATTCAACC
GGCTCCCAGAGCGTGATTAT -> GCTCCCAGAGCGTGATTATA
GAACGTATCCGTACTGGCAG -> AACGTATCCGTACTGGCAGA
ATCGGGAAAATCCTCCTCCA -> TCGGGAAAATCCTCCTCCAT
GGCCTATGCGAGACAGAATC -> GCCTATGCGAGACAGAATCT
ATGGTTTACTGCCTAAAGGC -> TGGTTTACTGCCTAAAGGCG
GTAGTCTGAGAGAGGCGGGG -> TAGTCTGAGAGAGGCGGGGT
CGTATGCCATGTGACTTGGA -> GTATGCCATGTGACTTGGAG
AATGCCTATCTACAAAAGGG -> ATGCCTATCTACAAAAGGGT
CTCCAGCTAAAAGCCGGGGA -> TCCAGCTAAAAGCCGGGGAA
CAATATGGCAGTGCTCCAGC -> AATATGGCAGTGCTCCAGCT
CGCATTAAAGAGATAGGCTA -> GCATTAAAGAGATAGGCTAG
AGAGACGCCTGAACCACCCT -> GAGACGCCTGAACCACCCTC
CCGGAACCCAACGACCGCCC -> CGGAACCCAACGACCGCCCA
TATGACATGAACCCGATTGT -> ATGACATGAACCCGATTGTT
GAGCGTGATTATAGAGGACA -> AGCGTGATTATAGAGGACAC
AGTGCCCCCTACGCATTAAA -> GTGCCCCCTACGCATTAAAG
CTCACCAATTCAACCGATTA -> TCACCAATTCAACCGATTAC
ACATGTCTGCCACATATGAC -> CATGTCTGCCACATATGACA
GCGATACTCGTGAGCTGAAG -> CGATACTCGTGAGCTGAAGG
CGTGAGCTGAAGGGCTCACT -> GTGAGCTGAAGGGCTCACTC
CTTGCCTAATCTTTGATCGG -> TTGCCTAATCTTTGATCGGG
CACTCGGTTCATTTGCACTA -> ACTCGGTTCATTTGCACTAC
GTTTAAGAACGTATCCGTAC -> TTTAAGAACGTATCCGTACT
ATGAACCCGATTGTTACGGG -> TGAACCCGATTGTTACGGGG
CAGCGGTCGAGGTCCGTACT -> AGCGGTCGAGGTCCGTACTA
ACTTTTACACTTGGCCTATG -> CTTTTACACTTGGCCTATGC
CTATGCGAGACAGAATCTTA -> TATGCGAGACAGAATCTTAT
ACGTATCCGTACTGGCAGAT -> CGTATCCGTACTGGCAGATC
TCCTCCTCCATGAACATTAC -> CCTCCTCCATGAACATTACC
GTTCAAGGACTTACTCGCAG -> TTCAAGGACTTACTCGCAGA
ACAACGATGCCCGGAACCCA -> CAACGATGCCCGGAACCCAA
GTTCTCTTGCCTAATCTTTG -> TTCTCTTGCCTAATCTTTGA
CTAATCTTTGATCGGGAAAA -> TAATCTTTGATCGGGAAAAT
ATGCCCGGAACCCAACGACC -> TGCCCGGAACCCAACGACCG
GACCTCAGGCTCGAGCTAAC -> ACCTCAGGCTCGAGCTAACG
ACCGATTACATGTCTGCCAC -> CCGATTACATGTCTGCCACA
AGCGGTCGAGGTCCGTACTA -> GCGGTCGAGGTCCGTACTAG
TGATTATAGAGGACACCAAA -> GATTATAGAGGACACCAAAA
CCACGTATGCCATGTGACTT -> CACGTATGCCATGTGACTTG
GAACAATATGGCAGTGCTCC -> AACAATATGGCAGTGCTCCA
TTACCGGCCGCACCTTAGTG -> TACCGGCCGCACCTTAGTGC
ATCTTATGCACCCACGTAGT -> TCTTATGCACCCACGTAGTC
ACTGCCTAAAGGCGTTCTCT -> CTGCCTAAAGGCGTTCTCTT
CCAGCGGTCGAGGTCCGTAC -> CAGCGGTCGAGGTCCGTACT
CTATGCTTCTGGTACACATC -> TATGCTTCTGGTACACATCA
AGGATACGTCGACGTATAAA -> GGATACGTCGACGTATAAAC
GAGAACGTACAGTACGGAGA -> AGAACGTACAGTACGGAGAG
ACCCAACGACCGCCCAAAAT -> CCCAACGACCGCCCAAAATC
GTTACGGGGACCATGAGGTC -> TTACGGGGACCATGAGGTCA
CCCTACGCATTAAAGAGATA -> CCTACGCATTAAAGAGATAG
GGTTCATTTGCACTACATTC -> GTTCATTTGCACTACATTCG
TCATCTGCTCCCGGGCAATG -> CATCTGCTCCCGGGCAATGT
GTCTGAGAGAGGCGGGGTTT -> TCTGAGAGAGGCGGGGTTTA
CGTAGTCTGAGAGAGGCGGG -> GTAGTCTGAGAGAGGCGGGG
CGCCACTCTTAACAGGGCCC -> GCCACTCTTAACAGGGCCCG
CCCCTACGCATTAAAGAGAT -> CCCTACGCATTAAAGAGATA
ACCAATTCAACCGATTACAT -> CCAATTCAACCGATTACATG
CATGACTGGCACTCGAATGC -> ATGACTGGCACTCGAATGCC
CACGTATGCCATGTGACTTG -> ACGTATGCCATGTGACTTGG
ATCTATGCTTCTGGTACACA -> TCTATGCTTCTGGTACACAT
ATTAAAGAGATAGGCTAGCG -> TTAAAGAGATAGGCTAGCGG
GGAGTATTGTCCATCGTCAA -> GAGTATTGTCCATCGTCAAC
CCGGGCAATGTACGACCTCA -> CGGGCAATGTACGACCTCAG
TACTGGCAGATCGGCAGTTC -> ACTGGCAGATCGGCAGTTCA
TTGCACTACATTCGTTTACT -> TGCACTACATTCGTTTACTG
AATGTACGACCTCAGGCTCG -> ATGTACGACCTCAGGCTCGA
CTGCTCCCGGGCAATGTACG -> TGCTCCCGGGCAATGTACGA
GGCTGTGGGAGAACGTACAG -> GCTGTGGGAGAACGTACAGT
ATCGCGATACTCGTGAGCTG -> TCGCGATACTCGTGAGCTGA
GCGCACGCGGGCTCCCAGAG -> CGCACGCGGGCTCCCAGAGC
CCGGGGAAGGTACCTGGCAC -> CGGGGAAGGTACCTGGCACG
AGGGTGAGTCATCCTCCCCA -> GGGTGAGTCATCCTCCCCAG
CAAGGACTTACTCGCAGAGA -> AAGGACTTACTCGCAGAGAC
GACAGAATCTTATGCACCCA -> ACAGAATCTTATGCACCCAC
CTGTGCAAGACAGGATCCAC -> TGTGCAAGACAGGATCCACG
GGAGAACGTACAGTACGGAG -> GAGAACGTACAGTACGGAGA
ATCCTTAAGACTTTTACACT -> TCCTTAAGACTTTTACACTT
CGGGAAAATCCTCCTCCATG -> GGGAAAATCCTCCTCCATGA
AGCTAACGCTCGGTCCCAAC -> GCTAACGCTCGGTCCCAACC
GACAAGATCTCACCAATTCA -> ACAAGATCTCACCAATTCAA
ATGGCAGTGCTCCAGCTAAA -> TGGCAGTGCTCCAGCTAAAA
TGGCGCACGCGGGCTCCCAG -> GGCGCACGCGGGCTCCCAGA
TGCTGTGCAAGACAGGATCC -> GCTGTGCAAGACAGGATCCA
TTCAAGGACTTACTCGCAGA -> TCAAGGACTTACTCGCAGAG
AAACTAATCCAATCACTTTG -> AACTAATCCAATCACTTTGA
ACCCGATTGTTACGGGGACC -> CCCGATTGTTACGGGGACCA
CATATGACATGAACCCGATT -> ATATGACATGAACCCGATTG
CCTATGGAGTATTGTCCATC -> CTATGGAGTATTGTCCATCG
GCGGATATCCTTAAGACTTT -> CGGATATCCTTAAGACTTTT
GTCCCAACCCCTATGGAGTA -> TCCCAACCCCTATGGAGTAT
ATGGAGTATTGTCCATCGTC -> TGGAGTATTGTCCATCGTCA
CGGTTCATTTGCACTACATT -> GGTTCATTTGCACTACATTC
GCCGCACCTTAGTGCGGATA -> CCGCACCTTAGTGCGGATAT
GTTTACTGCCTAAAGGCGTT -> TTTACTGCCTAAAGGCGTTC
CTGCCACATATGACATGAAC -> TGCCACATATGACATGAACC
TTTAAGAACGTATCCGTACT -> TTAAGAACGTATCCGTACTG
TATGCGAGACAGAATCTTAT -> ATGCGAGACAGAATCTTATG
TCATTTGCACTACATTCGTT -> CATTTGCACTACATTCGTTT
AATCTTTGATCGGGAAAATC -> ATCTTTGATCGGGAAAATCC
GAGGTCATGACTGGCACTCG -> AGGTCATGACTGGCACTCGA
CCCCTATGGAGTATTGTCCA -> CCCTATGGAGTATTGTCCAT
ACCCTCTGACAAAGGTAACA -> CCCTCTGACAAAGGTAACAT
GGGCTCCCAGAGCGTGATTA -> GGCTCCCAGAGCGTGATTAT
TCACTTTGAGCGCCACGAAA -> CACTTTGAGCGCCACGAAAA
GAACATTACCGGCCGCACCT -> AACATTACCGGCCGCACCTT
TAGGCTAGCGGCTCAGTAAT -> AGGCTAGCGGCTCAGTAATC
GTACGACCTCAGGCTCGAGC -> TACGACCTCAGGCTCGAGCT
TACACATCACAACGATGCCC -> ACACATCACAACGATGCCCG
GCCTATCTACAAAAGGGTGA -> CCTATCTACAAAAGGGTGAG
GCGGCTCAGTAATCGCGATA -> CGGCTCAGTAATCGCGATAC
AGACAGAATCTTATGCACCC -> GACAGAATCTTATGCACCCA
ACGCGGGCTCCCAGAGCGTG -> CGCGGGCTCCCAGAGCGTGA
CACCAAAATATGGTTTACTG -> ACCAAAATATGGTTTACTGC
TACATTCGTTTACTGGTACA -> ACATTCGTTTACTGGTACAA
TGATCGGGAAAATCCTCCTC -> GATCGGGAAAATCCTCCTCC
CCCCAGGTACAGTGCCCCCT -> CCCAGGTACAGTGCCCCCTA
GGGGACCATGAGGTCATGAC -> GGGACCATGAGGTCATGACT
GTCCGTACTAGGATACGTCG -> TCCGTACTAGGATACGTCGA
GAACGTACAGTACGGAGAGG -> AACGTACAGTACGGAGAGGC
CCATCGTCAACAGAAAGCGC -> CATCGTCAACAGAAAGCGCC
AACCACCCTCTGACAAAGGT -> ACCACCCTCTGACAAAGGTA
ATTGTCCATCGTCAACAGAA -> TTGTCCATCGTCAACAGAAA
TCCCAGAGCGTGATTATAGA -> CCCAGAGCGTGATTATAGAG
CTCGGTTCATTTGCACTACA -> TCGGTTCATTTGCACTACAT
TTAAAGAGATAGGCTAGCGG -> TAAAGAGATAGGCTAGCGGC
TTTACTGCCTAAAGGCGTTC -> TTACTGCCTAAAGGCGTTCT
CCACGAAAAGTGTGACTGGC -> CACGAAAAGTGTGACTGGCT
CTCCCGGGCAATGTACGACC -> TCCCGGGCAATGTACGACCT
GGGAACAATATGGCAGTGCT -> GGAACAATATGGCAGTGCTC
TAGCGGCTCAGTAATCGCGA -> AGCGGCTCAGTAATCGCGAT
AAAGCGCCCTCTCGACAAGA -> AAGCGCCCTCTCGACAAGAT
CAGTTCAAGGACTTACTCGC -> AGTTCAAGGACTTACTCGCA
GATTGTTACGGGGACCATGA -> ATTGTTACGGGGACCATGAG
TCCCCAGGTACAGTGCCCCC -> CCCCAGGTACAGTGCCCCCT
ACGGGGACCATGAGGTCATG -> CGGGGACCATGAGGTCATGA
GGCAGTGCTCCAGCTAAAAG -> GCAGTGCTCCAGCTAAAAGC
AAATATGGTTTACTGCCTAA -> AATATGGTTTACTGCCTAAA
ACGTAGTCTGAGAGAGGCGG -> CGTAGTCTGAGAGAGGCGGG
ACTGGCTGTGGGAGAACGTA -> CTGGCTGTGGGAGAACGTAC
CTCCGTGCTTTCGCTGTCAT -> TCCGTGCTTTCGCTGTCATC
GGATATCCTTAAGACTTTTA -> GATATCCTTAAGACTTTTAC
CACCCACGTAGTCTGAGAGA -> ACCCACGTAGTCTGAGAGAG
GATTATAGAGGACACCAAAA -> ATTATAGAGGACACCAAAAT
TCGTTTACTGGTACAAATGC -> CGTTTACTGGTACAAATGCA
CCTACGCATTAAAGAGATAG -> CTACGCATTAAAGAGATAGG
CCGCACCTTAGTGCGGATAT -> CGCACCTTAGTGCGGATATC
CGATACTCGTGAGCTGAAGG -> GATACTCGTGAGCTGAAGGG
TTGTTACGGGGACCATGAGG -> TGTTACGGGGACCATGAGGT
GTCGCTCCGTGCTTTCGCTG -> TCGCTCCGTGCTTTCGCTGT
TGTGTGTCGCTCCGTGCTTT -> GTGTGTCGCTCCGTGCTTTC
GAGACAGAATCTTATGCACC -> AGACAGAATCTTATGCACCC
TTGTGTGTCGCTCCGTGCTT -> TGTGTGTCGCTCCGTGCTTT
GTGTCGCTCCGTGCTTTCGC -> TGTCGCTCCGTGCTTTCGCT
GTCATCTGCTCCCGGGCAAT -> TCATCTGCTCCCGGGCAATG
GAGGACACCAAAATATGGTT -> AGGACACCAAAATATGGTTT
TGTCATCTGCTCCCGGGCAA -> GTCATCTGCTCCCGGGCAAT
AGATAGGCTAGCGGCTCAGT -> GATAGGCTAGCGGCTCAGTA
CGATGCCCGGAACCCAACGA -> GATGCCCGGAACCCAACGAC
ACTTACTCGCAGAGACGCCT -> CTTACTCGCAGAGACGCCTG
GCGTCTGCTGTGCAAGACAG -> CGTCTGCTGTGCAAGACAGG
ATATGGTTTACTGCCTAAAG -> TATGGTTTACTGCCTAAAGG
GGAACCCAACGACCGCCCAA -> GAACCCAACGACCGCCCAAA
ATGTACGACCTCAGGCTCGA -> TGTACGACCTCAGGCTCGAG
TAAAGAGATAGGCTAGCGGC -> AAAGAGATAGGCTAGCGGCT
CTCTTGCCTAATCTTTGATC -> TCTTGCCTAATCTTTGATCG
CGGCAGTTCAAGGACTTACT -> GGCAGTTCAAGGACTTACTC
GGCAGTTCAAGGACTTACTC -> GCAGTTCAAGGACTTACTCG
TGGCAGTGCTCCAGCTAAAA -> GGCAGTGCTCCAGCTAAAAG
CCACTCTTAACAGGGCCCGT -> CACTCTTAACAGGGCCCGTA
AAGACAGGATCCACGTATGC -> AGACAGGATCCACGTATGCC
ATTGTTACGGGGACCATGAG -> TTGTTACGGGGACCATGAGG
GAAGGGCTCACTCGGTTCAT -> AAGGGCTCACTCGGTTCATT
ATTATAGAGGACACCAAAAT -> TTATAGAGGACACCAAAATA
CGCGCCACTCTTAACAGGGC -> GCGCCACTCTTAACAGGGCC
AGGTACAGTGCCCCCTACGC -> GGTACAGTGCCCCCTACGCA
CGTATCCGTACTGGCAGATC -> GTATCCGTACTGGCAGATCG
CAACAGAAAGCGCCCTCTCG -> AACAGAAAGCGCCCTCTCGA
AATATGGCAGTGCTCCAGCT -> ATATGGCAGTGCTCCAGCTA
TAATCCAATCACTTTGAGCG -> AATCCAATCACTTTGAGCGC
TGAGGTCATGACTGGCACTC -> GAGGTCATGACTGGCACTCG
GACTGGCTGTGGGAGAACGT -> ACTGGCTGTGGGAGAACGTA
GCTCCCAGAGCGTGATTATA -> CTCCCAGAGCGTGATTATAG
GATCGGGAAAATCCTCCTCC -> ATCGGGAAAATCCTCCTCCA
CTTTTGTGTGTCGCTCCGTG -> TTTTGTGTGTCGCTCCGTGC
CATGTGACTTGGAGTGGCGC -> ATGTGACTTGGAGTGGCGCA
TCCCGCGTCTGCTGTGCAAG -> CCCGCGTCTGCTGTGCAAGA
CCCGCGTCTGCTGTGCAAGA -> CCGCGTCTGCTGTGCAAGAC
GCAGTTCAAGGACTTACTCG -> CAGTTCAAGGACTTACTCGC
CCGGCCGCACCTTAGTGCGG -> CGGCCGCACCTTAGTGCGGA
GGTTTACTGCCTAAAGGCGT -> GTTTACTGCCTAAAGGCGTT
CCTGGCACGCGCCACTCTTA -> CTGGCACGCGCCACTCTTAA
TACTAGGATACGTCGACGTA -> ACTAGGATACGTCGACGTAT
ACAGTGCCCCCTACGCATTA -> CAGTGCCCCCTACGCATTAA
CTATCTACAAAAGGGTGAGT -> TATCTACAAAAGGGTGAGTC
ACCATGAGGTCATGACTGGC -> CCATGAGGTCATGACTGGCA
ACTCGGTTCATTTGCACTAC -> CTCGGTTCATTTGCACTACA
ACGTCGACGTATAAACTAAT -> CGTCGACGTATAAACTAATC
GATCGGCAGTTCAAGGACTT -> ATCGGCAGTTCAAGGACTTA
AGGTAACATATCTTTACTGT -> GGTAACATATCTTTACTGTT
TTTGATCGGGAAAATCCTCC -> TTGATCGGGAAAATCCTCCT
ACATTCGTTTACTGGTACAA -> CATTCGTTTACTGGTACAAA
ATCCACGTATGCCATGTGAC -> TCCACGTATGCCATGTGACT
CCGATTACATGTCTGCCACA -> CGATTACATGTCTGCCACAT
TGCCATGTGACTTGGAGTGG -> GCCATGTGACTTGGAGTGGC
ACGACCTCAGGCTCGAGCTA -> CGACCTCAGGCTCGAGCTAA
ATGTCTGCCACATATGACAT -> TGTCTGCCACATATGACATG
CAAATGCAGACCAGCGGTCG -> AAATGCAGACCAGCGGTCGA
GATTACATGTCTGCCACATA -> ATTACATGTCTGCCACATAT
TAAGACTTTTACACTTGGCC -> AAGACTTTTACACTTGGCCT
TGAACATTACCGGCCGCACC -> GAACATTACCGGCCGCACCT
CTGTGGGAGAACGTACAGTA -> TGTGGGAGAACGTACAGTAC
CGTACTAGGATACGTCGACG -> GTACTAGGATACGTCGACGT
GCACGCGCCACTCTTAACAG -> CACGCGCCACTCTTAACAGG
TACGCATTAAAGAGATAGGC -> ACGCATTAAAGAGATAGGCT
CGCACGCGGGCTCCCAGAGC -> GCACGCGGGCTCCCAGAGCG
CTGTTCATCTATGCTTCTGG -> TGTTCATCTATGCTTCTGGT
CATCGTCAACAGAAAGCGCC -> ATCGTCAACAGAAAGCGCCC
TGTACGACCTCAGGCTCGAG -> GTACGACCTCAGGCTCGAGC
GAGCTGAAGGGCTCACTCGG -> AGCTGAAGGGCTCACTCGGT
AAGGGAACAATATGGCAGTG -> AGGGAACAATATGGCAGTGC
GTCATCCTCCCCAGGTACAG -> TCATCCTCCCCAGGTACAGT
GACCATGAGGTCATGACTGG -> ACCATGAGGTCATGACTGGC
TACACTTGGCCTATGCGAGA -> ACACTTGGCCTATGCGAGAC
TTATAGAGGACACCAAAATA -> TATAGAGGACACCAAAATAT
TTGTCCATCGTCAACAGAAA -> TGTCCATCGTCAACAGAAAG
ACATATGACATGAACCCGAT -> CATATGACATGAACCCGATT
TACAAAAGGGTGAGTCATCC -> ACAAAAGGGTGAGTCATCCT
AACAATATGGCAGTGCTCCA -> ACAATATGGCAGTGCTCCAG
ACATGAACCCGATTGTTACG -> CATGAACCCGATTGTTACGG
AGAGGACACCAAAATATGGT -> GAGGACACCAAAATATGGTT
CACCAATTCAACCGATTACA -> ACCAATTCAACCGATTACAT
AAAGGCGTTCTCTTGCCTAA -> AAGGCGTTCTCTTGCCTAAT
CCCTCTCGACAAGATCTCAC -> CCTCTCGACAAGATCTCACC
ACAAAGGTAACATATCTTTA -> CAAAGGTAACATATCTTTAC
AGAATCTTATGCACCCACGT -> GAATCTTATGCACCCACGTA
GAAGGTACCTGGCACGCGCC -> AAGGTACCTGGCACGCGCCA
TACTGCCTAAAGGCGTTCTC -> ACTGCCTAAAGGCGTTCTCT
CTTTGATCGGGAAAATCCTC -> TTTGATCGGGAAAATCCTCC
TGCAGACCAGCGGTCGAGGT -> GCAGACCAGCGGTCGAGGTC
CTCCATGAACATTACCGGCC -> TCCATGAACATTACCGGCCG
GGGCAATGTACGACCTCAGG -> GGCAATGTACGACCTCAGGC
CTACGCATTAAAGAGATAGG -> TACGCATTAAAGAGATAGGC
TTTTACACTTGGCCTATGCG -> TTTACACTTGGCCTATGCGA
CAGGTACAGTGCCCCCTACG -> AGGTACAGTGCCCCCTACGC
TCGGCAGTTCAAGGACTTAC -> CGGCAGTTCAAGGACTTACT
ACGACCGCCCAAAATCCACC -> CGACCGCCCAAAATCCACCA
AGAACGTATCCGTACTGGCA -> GAACGTATCCGTACTGGCAG
CGAATGCCTATCTACAAAAG -> GAATGCCTATCTACAAAAGG
ACCAAAATATGGTTTACTGC -> CCAAAATATGGTTTACTGCC
ATCGTCAACAGAAAGCGCCC -> TCGTCAACAGAAAGCGCCCT
AGGGCCCGTATGACCCTTTT -> GGGCCCGTATGACCCTTTTG
ATATGGCAGTGCTCCAGCTA -> TATGGCAGTGCTCCAGCTAA
ACCAGCGGTCGAGGTCCGTA -> CCAGCGGTCGAGGTCCGTAC
ACTGGCAGATCGGCAGTTCA -> CTGGCAGATCGGCAGTTCAA
GAAAATCCTCCTCCATGAAC -> AAAATCCTCCTCCATGAACA
TCTTATGCACCCACGTAGTC -> CTTATGCACCCACGTAGTCT
GGAGTGGCGCACGCGGGCTC -> GAGTGGCGCACGCGGGCTCC
TCCACCAAGGGAACAATATG -> CCACCAAGGGAACAATATGG
ATACTCGTGAGCTGAAGGGC -> TACTCGTGAGCTGAAGGGCT
GGTACCTGGCACGCGCCACT -> GTACCTGGCACGCGCCACTC
AAAATCCACCAAGGGAACAA -> AAATCCACCAAGGGAACAAT
CCCGGAACCCAACGACCGCC -> CCGGAACCCAACGACCGCCC
TCTCGACAAGATCTCACCAA -> CTCGACAAGATCTCACCAAT
TCTGGTACACATCACAACGA -> CTGGTACACATCACAACGAT
TGCAAGACAGGATCCACGTA -> GCAAGACAGGATCCACGTAT
GCCACATATGACATGAACCC -> CCACATATGACATGAACCCG
AAAAGGGTGAGTCATCCTCC -> AAAGGGTGAGTCATCCTCCC
CATGTCTGCCACATATGACA -> ATGTCTGCCACATATGACAT
CGAGGTCCGTACTAGGATAC -> GAGGTCCGTACTAGGATACG
CTCGTGAGCTGAAGGGCTCA -> TCGTGAGCTGAAGGGCTCAC
TCTGACAAAGGTAACATATC -> CTGACAAAGGTAACATATCT
ATGCTTCTGGTACACATCAC -> TGCTTCTGGTACACATCACA
GGCGTTCTCTTGCCTAATCT -> GCGTTCTCTTGCCTAATCTT
ACAATATGGCAGTGCTCCAG -> CAATATGGCAGTGCTCCAGC
AGTAATCGCGATACTCGTGA -> GTAATCGCGATACTCGTGAG
GCCCGGAACCCAACGACCGC -> CCCGGAACCCAACGACCGCC
AATCCAATCACTTTGAGCGC -> ATCCAATCACTTTGAGCGCC
GGACTTACTCGCAGAGACGC -> GACTTACTCGCAGAGACGCC
GCTGTGGGAGAACGTACAGT -> CTGTGGGAGAACGTACAGTA
CAGACCAGCGGTCGAGGTCC -> AGACCAGCGGTCGAGGTCCG
CAAAATATGGTTTACTGCCT -> AAAATATGGTTTACTGCCTA
CTGGTACACATCACAACGAT -> TGGTACACATCACAACGATG
TTCAACCGATTACATGTCTG -> TCAACCGATTACATGTCTGC
ATAAACTAATCCAATCACTT -> TAAACTAATCCAATCACTTT
ATCACAACGATGCCCGGAAC -> TCACAACGATGCCCGGAACC
ACCTCAGGCTCGAGCTAACG -> CCTCAGGCTCGAGCTAACGC
TCATCTATGCTTCTGGTACA -> CATCTATGCTTCTGGTACAC
GGGAGAACGTACAGTACGGA -> GGAGAACGTACAGTACGGAG
CTCACTCGGTTCATTTGCAC -> TCACTCGGTTCATTTGCACT
GAACCACCCTCTGACAAAGG -> AACCACCCTCTGACAAAGGT
CAGAGCGTGATTATAGAGGA -> AGAGCGTGATTATAGAGGAC
GTACAAATGCAGACCAGCGG -> TACAAATGCAGACCAGCGGT
GGGACCATGAGGTCATGACT -> GGACCATGAGGTCATGACTG
TCTATGCTTCTGGTACACAT -> CTATGCTTCTGGTACACATC
CGGGGACCATGAGGTCATGA -> GGGGACCATGAGGTCATGAC
ACTTTGAGCGCCACGAAAAG -> CTTTGAGCGCCACGAAAAGT
CGGGCTCCCAGAGCGTGATT -> GGGCTCCCAGAGCGTGATTA
GTACCTGGCACGCGCCACTC -> TACCTGGCACGCGCCACTCT
GGGTGAGTCATCCTCCCCAG -> GGTGAGTCATCCTCCCCAGG
CGATTACATGTCTGCCACAT -> GATTACATGTCTGCCACATA
ATCCACCAAGGGAACAATAT -> TCCACCAAGGGAACAATATG
GGAAGGTACCTGGCACGCGC -> GAAGGTACCTGGCACGCGCC
CTTAACAGGGCCCGTATGAC -> TTAACAGGGCCCGTATGACC
CTCTCGACAAGATCTCACCA -> TCTCGACAAGATCTCACCAA
CGCCACGAAAAGTGTGACTG -> GCCACGAAAAGTGTGACTGG
TGGCAGATCGGCAGTTCAAG -> GGCAGATCGGCAGTTCAAGG
TCATCCTCCCCAGGTACAGT -> CATCCTCCCCAGGTACAGTG
TACTGGTACAAATGCAGACC -> ACTGGTACAAATGCAGACCA
CGAGACAGAATCTTATGCAC -> GAGACAGAATCTTATGCACC
CTCAGTAATCGCGATACTCG -> TCAGTAATCGCGATACTCGT
TCGCTGTCATCTGCTCCCGG -> CGCTGTCATCTGCTCCCGGG
GGGAAAATCCTCCTCCATGA -> GGAAAATCCTCCTCCATGAA
AGGCTAGCGGCTCAGTAATC -> GGCTAGCGGCTCAGTAATCG
TCGCAGAGACGCCTGAACCA -> CGCAGAGACGCCTGAACCAC
GGTGAGTCATCCTCCCCAGG -> GTGAGTCATCCTCCCCAGGT
TCTTTGATCGGGAAAATCCT -> CTTTGATCGGGAAAATCCTC
CAACGACCGCCCAAAATCCA -> AACGACCGCCCAAAATCCAC
TGAACCACCCTCTGACAAAG -> GAACCACCCTCTGACAAAGG
CCTCCCCAGGTACAGTGCCC -> CTCCCCAGGTACAGTGCCCC
TACTCGTGAGCTGAAGGGCT -> ACTCGTGAGCTGAAGGGCTC
GGCACGCGCCACTCTTAACA -> GCACGCGCCACTCTTAACAG
TCATGACTGGCACTCGAATG -> CATGACTGGCACTCGAATGC
CGGGGAAGGTACCTGGCACG -> GGGGAAGGTACCTGGCACGC
GGAAAATCCTCCTCCATGAA -> GAAAATCCTCCTCCATGAAC
TACCGGCCGCACCTTAGTGC -> ACCGGCCGCACCTTAGTGCG
GTACTGGCAGATCGGCAGTT -> TACTGGCAGATCGGCAGTTC
AATCCTCCTCCATGAACATT -> ATCCTCCTCCATGAACATTA
GTACACATCACAACGATGCC -> TACACATCACAACGATGCCC
CTGAAGGGCTCACTCGGTTC -> TGAAGGGCTCACTCGGTTCA
CACTCTTAACAGGGCCCGTA -> ACTCTTAACAGGGCCCGTAT
CAGGGCCCGTATGACCCTTT -> AGGGCCCGTATGACCCTTTT
GTGACTTGGAGTGGCGCACG -> TGACTTGGAGTGGCGCACGC
GAGATCCCGCGTCTGCTGTG -> AGATCCCGCGTCTGCTGTGC
GGTCGAGGTCCGTACTAGGA -> GTCGAGGTCCGTACTAGGAT
TCTCACCAATTCAACCGATT -> CTCACCAATTCAACCGATTA
GATCCACGTATGCCATGTGA -> ATCCACGTATGCCATGTGAC
CGTATAAACTAATCCAATCA -> GTATAAACTAATCCAATCAC
TGAGTCATCCTCCCCAGGTA -> GAGTCATCCTCCCCAGGTAC
TATGACCCTTTTGTGTGTCG -> ATGACCCTTTTGTGTGTCGC
GTAATCGCGATACTCGTGAG -> TAATCGCGATACTCGTGAGC
GTCTGCTGTGCAAGACAGGA -> TCTGCTGTGCAAGACAGGAT
GGACCATGAGGTCATGACTG -> GACCATGAGGTCATGACTGG
CGTGCTTTCGCTGTCATCTG -> GTGCTTTCGCTGTCATCTGC
AACGTATCCGTACTGGCAGA -> ACGTATCCGTACTGGCAGAT
AAAATCCTCCTCCATGAACA -> AAATCCTCCTCCATGAACAT
AAATCCACCAAGGGAACAAT -> AATCCACCAAGGGAACAATA
AACGTACAGTACGGAGAGGC -> ACGTACAGTACGGAGAGGCG
GCTAGCGGCTCAGTAATCGC -> CTAGCGGCTCAGTAATCGCG
TAGTGCGGATATCCTTAAGA -> AGTGCGGATATCCTTAAGAC
CAATTCAACCGATTACATGT -> AATTCAACCGATTACATGTC
AGTTCAAGGACTTACTCGCA -> GTTCAAGGACTTACTCGCAG
TACAGTACGGAGAGGCGAGG -> ACAGTACGGAGAGGCGAGGG
GAGTCATCCTCCCCAGGTAC -> AGTCATCCTCCCCAGGTACA
TCCACGTATGCCATGTGACT -> CCACGTATGCCATGTGACTT
TAACAGGGCCCGTATGACCC -> AACAGGGCCCGTATGACCCT
AGATCCCGCGTCTGCTGTGC -> GATCCCGCGTCTGCTGTGCA
ATCTCACCAATTCAACCGAT -> TCTCACCAATTCAACCGATT
CCGCGTCTGCTGTGCAAGAC -> CGCGTCTGCTGTGCAAGACA
TGGGAGAACGTACAGTACGG -> GGGAGAACGTACAGTACGGA
GGCTCACTCGGTTCATTTGC -> GCTCACTCGGTTCATTTGCA
TGCCCCCTACGCATTAAAGA -> GCCCCCTACGCATTAAAGAG
AACCCGATTGTTACGGGGAC -> ACCCGATTGTTACGGGGACC
AGATCGGCAGTTCAAGGACT -> GATCGGCAGTTCAAGGACTT
CAGAAAGCGCCCTCTCGACA -> AGAAAGCGCCCTCTCGACAA
CACTCGAATGCCTATCTACA -> ACTCGAATGCCTATCTACAA
ACGATGCCCGGAACCCAACG -> CGATGCCCGGAACCCAACGA
GACGTATAAACTAATCCAAT -> ACGTATAAACTAATCCAATC
CCAGAGCGTGATTATAGAGG -> CAGAGCGTGATTATAGAGGA
CGTCAACAGAAAGCGCCCTC -> GTCAACAGAAAGCGCCCTCT
TGCGGATATCCTTAAGACTT -> GCGGATATCCTTAAGACTTT
GGACACCAAAATATGGTTTA -> GACACCAAAATATGGTTTAC
TACGTCGACGTATAAACTAA -> ACGTCGACGTATAAACTAAT
AGGCGGGGTTTAAGAACGTA -> GGCGGGGTTTAAGAACGTAT
GAACCCGATTGTTACGGGGA -> AACCCGATTGTTACGGGGAC
TGAACCCGATTGTTACGGGG -> GAACCCGATTGTTACGGGGA
ATATCTTTACTGTTCATCTA -> TATCTTTACTGTTCATCTAT
CATATCTTTACTGTTCATCT -> ATATCTTTACTGTTCATCTA
CAAAAGGGTGAGTCATCCTC -> AAAAGGGTGAGTCATCCTCC
CAAGACAGGATCCACGTATG -> AAGACAGGATCCACGTATGC
CTGGCTGTGGGAGAACGTAC -> TGGCTGTGGGAGAACGTACA
TGGTACACATCACAACGATG -> GGTACACATCACAACGATGC
TTAACAGGGCCCGTATGACC -> TAACAGGGCCCGTATGACCC
ATGCCATGTGACTTGGAGTG -> TGCCATGTGACTTGGAGTGG
CCCTCTGACAAAGGTAACAT -> CCTCTGACAAAGGTAACATA
TATAGAGGACACCAAAATAT -> ATAGAGGACACCAAAATATG
CACATCACAACGATGCCCGG -> ACATCACAACGATGCCCGGA
CCAAAATCCACCAAGGGAAC -> CAAAATCCACCAAGGGAACA
CCATGTGACTTGGAGTGGCG -> CATGTGACTTGGAGTGGCGC
TTACATGTCTGCCACATATG -> TACATGTCTGCCACATATGA
TATCTTTACTGTTCATCTAT -> ATCTTTACTGTTCATCTATG
AACGCTCGGTCCCAACCCCT -> ACGCTCGGTCCCAACCCCTA
TATGCCATGTGACTTGGAGT -> ATGCCATGTGACTTGGAGTG
GGGTTTAAGAACGTATCCGT -> GGTTTAAGAACGTATCCGTA
TCGGGAAAATCCTCCTCCAT -> CGGGAAAATCCTCCTCCATG
CGCCCAAAATCCACCAAGGG -> GCCCAAAATCCACCAAGGGA
GAATCTTATGCACCCACGTA -> AATCTTATGCACCCACGTAG
TCTGCTCCCGGGCAATGTAC -> CTGCTCCCGGGCAATGTACG
ATGACCCTTTTGTGTGTCGC -> TGACCCTTTTGTGTGTCGCT
ACCTGGCACGCGCCACTCTT -> CCTGGCACGCGCCACTCTTA
AGGGCTCACTCGGTTCATTT -> GGGCTCACTCGGTTCATTTG
TCGCGATACTCGTGAGCTGA -> CGCGATACTCGTGAGCTGAA
AAGACTTTTACACTTGGCCT -> AGACTTTTACACTTGGCCTA
CCAGGTACAGTGCCCCCTAC -> CAGGTACAGTGCCCCCTACG
TCTACAAAAGGGTGAGTCAT -> CTACAAAAGGGTGAGTCATC
TTCGTTTACTGGTACAAATG -> TCGTTTACTGGTACAAATGC
GCTCCCGGGCAATGTACGAC -> CTCCCGGGCAATGTACGACC
GTGGCGCACGCGGGCTCCCA -> TGGCGCACGCGGGCTCCCAG
CTAATCCAATCACTTTGAGC -> TAATCCAATCACTTTGAGCG
GCGAGACAGAATCTTATGCA -> CGAGACAGAATCTTATGCAC
TACTCGCAGAGACGCCTGAA -> ACTCGCAGAGACGCCTGAAC
CTAAAAGCCGGGGAAGGTAC -> TAAAAGCCGGGGAAGGTACC
CATGAACCCGATTGTTACGG -> ATGAACCCGATTGTTACGGG
AACATTACCGGCCGCACCTT -> ACATTACCGGCCGCACCTTA
GCTTTCGCTGTCATCTGCTC -> CTTTCGCTGTCATCTGCTCC
GCCCCCTACGCATTAAAGAG -> CCCCCTACGCATTAAAGAGA
ACCAAGGGAACAATATGGCA -> CCAAGGGAACAATATGGCAG
ACTACATTCGTTTACTGGTA -> CTACATTCGTTTACTGGTAC
CCGTGCTTTCGCTGTCATCT -> CGTGCTTTCGCTGTCATCTG
TCTTGCCTAATCTTTGATCG -> CTTGCCTAATCTTTGATCGG
AAAAGCCGGGGAAGGTACCT -> AAAGCCGGGGAAGGTACCTG
CATGAGGTCATGACTGGCAC -> ATGAGGTCATGACTGGCACT
GCATTAAAGAGATAGGCTAG -> CATTAAAGAGATAGGCTAGC
TCTGCTGTGCAAGACAGGAT -> CTGCTGTGCAAGACAGGATC
GTTCATCTATGCTTCTGGTA -> TTCATCTATGCTTCTGGTAC
GGTACACATCACAACGATGC -> GTACACATCACAACGATGCC
GTACAGTGCCCCCTACGCAT -> TACAGTGCCCCCTACGCATT
CGAGCTAACGCTCGGTCCCA -> GAGCTAACGCTCGGTCCCAA
GGCACTCGAATGCCTATCTA -> GCACTCGAATGCCTATCTAC
TTCTGGTACACATCACAACG -> TCTGGTACACATCACAACGA
AGGACTTACTCGCAGAGACG -> GGACTTACTCGCAGAGACGC
AGTGTGACTGGCTGTGGGAG -> GTGTGACTGGCTGTGGGAGA
AGGTCATGACTGGCACTCGA -> GGTCATGACTGGCACTCGAA
GCCTAATCTTTGATCGGGAA -> CCTAATCTTTGATCGGGAAA
GCGGTCGAGGTCCGTACTAG -> CGGTCGAGGTCCGTACTAGG
GTGGGAGAACGTACAGTACG -> TGGGAGAACGTACAGTACGG
AGACAGGATCCACGTATGCC -> GACAGGATCCACGTATGCCA
TACAAATGCAGACCAGCGGT -> ACAAATGCAGACCAGCGGTC
AATGCAGACCAGCGGTCGAG -> ATGCAGACCAGCGGTCGAGG
ATATCCTTAAGACTTTTACA -> TATCCTTAAGACTTTTACAC
GTCTGCCACATATGACATGA -> TCTGCCACATATGACATGAA
AAGAGATAGGCTAGCGGCTC -> AGAGATAGGCTAGCGGCTCA
ATAGGCTAGCGGCTCAGTAA -> TAGGCTAGCGGCTCAGTAAT
TTGGAGTGGCGCACGCGGGC -> TGGAGTGGCGCACGCGGGCT
TTGGCCTATGCGAGACAGAA -> TGGCCTATGCGAGACAGAAT
TCTGAGAGAGGCGGGGTTTA -> CTGAGAGAGGCGGGGTTTAA
GCTGTGCAAGACAGGATCCA -> CTGTGCAAGACAGGATCCAC
ACTAATCCAATCACTTTGAG -> CTAATCCAATCACTTTGAGC
TGCTTCTGGTACACATCACA -> GCTTCTGGTACACATCACAA
TGACTGGCACTCGAATGCCT -> GACTGGCACTCGAATGCCTA
TCCCAACCCCTATGGAGTAT -> CCCAACCCCTATGGAGTATT
GAAAGCGCCCTCTCGACAAG -> AAAGCGCCCTCTCGACAAGA
ATCTTTGATCGGGAAAATCC -> TCTTTGATCGGGAAAATCCT
ATTCGTTTACTGGTACAAAT -> TTCGTTTACTGGTACAAATG
TCGAATGCCTATCTACAAAA -> CGAATGCCTATCTACAAAAG
CAAAGGTAACATATCTTTAC -> AAAGGTAACATATCTTTACT
GATAGGCTAGCGGCTCAGTA -> ATAGGCTAGCGGCTCAGTAA
CTCGACAAGATCTCACCAAT -> TCGACAAGATCTCACCAATT
TGGCACTCGAATGCCTATCT -> GGCACTCGAATGCCTATCTA
ACCGGCCGCACCTTAGTGCG -> CCGGCCGCACCTTAGTGCGG